ID,Date,Year,season,Round,Region,F.Rate,F.Rank,F.Seed,F.Team,F.Score,U.Rate,U.Rank,U.Seed,U.Team,U.Score,Overtime,MV,SeD,Upset
1,12-Mar-02,2002,2001-02,PI,East,-1.21,174,16,Siena,81,-8.71,252,16,Alcorn St.,77,,4,0,
2,14-Mar-02,2002,2001-02,1,South,20.67,12,4,USC,89,11.32,65,13,UNC Wilmington,93,1 OT,4,-9,13 over 4
3,14-Mar-02,2002,2001-02,1,East,21.47,11,5,Marquette,69,15.59,41,12,Tulsa,71,,2,-7,12 over 5
4,14-Mar-02,2002,2001-02,1,West,17.49,29,12,Missouri,93,15.77,39,5,Miami FL,80,,13,-7,12 over 5
5,14-Mar-02,2002,2001-02,1,West,18.51,24,6,Gonzaga,66,11.01,67,11,Wyoming,73,,7,-5,11 over 6
6,14-Mar-02,2002,2001-02,1,East,22.21,10,4,Kentucky,83,13.63,47,13,Valparaiso,68,,15,9,
7,14-Mar-02,2002,2001-02,1,Midwest,28.99,4,1,Kansas,70,-0.24,162,16,Holy Cross,59,,11,15,
8,14-Mar-02,2002,2001-02,1,Midwest,22.97,9,2,Oregon,81,-4.51,210,15,Montana,62,,19,13,
9,14-Mar-02,2002,2001-02,1,Midwest,17.35,30,7,Wake Forest,83,11.72,62,10,Pepperdine,74,,9,3,
10,14-Mar-02,2002,2001-02,1,Midwest,20.32,15,8,Stanford,84,14.51,44,9,Western Kentucky,68,,16,1,
11,14-Mar-02,2002,2001-02,1,South,34.19,1,1,Duke,84,-5.31,219,16,Winthrop,37,,47,15,
12,14-Mar-02,2002,2001-02,1,South,18.73,22,2,Alabama,86,-2.5,191,15,Florida Atlantic,78,,8,13,
13,14-Mar-02,2002,2001-02,1,South,24.8,6,5,Indiana,75,14.08,45,12,Utah,56,,19,7,
14,14-Mar-02,2002,2001-02,1,South,19.27,19,8,Notre Dame,82,15.73,40,9,Charlotte,63,,19,1,
15,14-Mar-02,2002,2001-02,1,West,20.54,13,3,Arizona,86,8.87,77,14,UC Santa Barbara,81,,5,11,
16,14-Mar-02,2002,2001-02,1,West,19.76,17,4,Ohio St.,69,3.7,119,13,Davidson,64,,5,9,
17,14-Mar-02,2002,2001-02,1,South,20.39,14,10,Kent St.,69,15.8,38,7,Oklahoma St.,61,,8,-3,10 over 7
18,15-Mar-02,2002,2001-02,1,Midwest,24.72,7,5,Florida,82,11.82,59,12,Creighton,83,2 OT,1,-7,12 over 5
19,15-Mar-02,2002,2001-02,1,East,17.24,31,6,Texas Tech,68,13.45,49,11,Southern Illinois,76,,8,-5,11 over 6
20,15-Mar-02,2002,2001-02,1,East,29.25,3,1,Maryland,85,-1.21,174,16,Siena,70,,15,15,
21,15-Mar-02,2002,2001-02,1,East,19.36,18,2,Connecticut,78,3.99,116,15,Hampton,67,,11,13,
22,15-Mar-02,2002,2001-02,1,East,18.44,25,3,Georgia,85,1.35,146,14,Murray St.,68,,17,11,
23,15-Mar-02,2002,2001-02,1,East,19.15,21,7,North Carolina St.,69,16.86,32,10,Michigan St.,58,,11,3,
24,15-Mar-02,2002,2001-02,1,East,13.22,50,8,Wisconsin,80,9.06,76,9,St. John's,70,,10,1,
25,15-Mar-02,2002,2001-02,1,Midwest,18.25,26,3,Mississippi St.,70,5.39,100,14,McNeese St.,58,,12,11,
26,15-Mar-02,2002,2001-02,1,Midwest,23.21,8,4,Illinois,93,9.29,74,13,San Diego St.,64,,29,9,
27,15-Mar-02,2002,2001-02,1,Midwest,17.69,27,6,Texas,70,9.97,71,11,Boston College,57,,13,5,
28,15-Mar-02,2002,2001-02,1,South,19.94,16,3,Pittsburgh,71,0.93,150,14,Central Connecticut,54,,17,11,
29,15-Mar-02,2002,2001-02,1,South,16.03,37,6,California,82,12.23,58,11,Penn,75,,7,5,
30,15-Mar-02,2002,2001-02,1,West,30.19,2,1,Cincinnati,90,-2.74,194,16,Boston University,52,,38,15,
31,15-Mar-02,2002,2001-02,1,West,26.04,5,2,Oklahoma,71,3.85,118,15,Illinois Chicago,63,,8,13,
32,15-Mar-02,2002,2001-02,1,West,18.6,23,7,Xavier,70,13.15,51,10,Hawaii,58,,12,3,
33,15-Mar-02,2002,2001-02,1,West,16.68,34,9,Mississippi,58,16.34,35,8,UCLA,80,,22,1,
34,16-Mar-02,2002,2001-02,2,South,20.39,14,10,Kent St.,71,18.73,22,2,Alabama,58,,13,-8,10 over 2
35,16-Mar-02,2002,2001-02,2,West,19.76,17,4,Ohio St.,67,17.49,29,12,Missouri,83,,16,-8,12 over 4
36,16-Mar-02,2002,2001-02,2,East,22.21,10,4,Kentucky,87,15.59,41,12,Tulsa,82,,5,8,
37,16-Mar-02,2002,2001-02,2,Midwest,28.99,4,1,Kansas,86,20.32,15,8,Stanford,63,,23,7,
38,16-Mar-02,2002,2001-02,2,Midwest,22.97,9,2,Oregon,92,17.35,30,7,Wake Forest,87,,5,5,
39,16-Mar-02,2002,2001-02,2,South,34.19,1,1,Duke,84,19.27,19,8,Notre Dame,77,,7,7,
40,16-Mar-02,2002,2001-02,2,South,24.8,6,5,Indiana,76,11.32,65,13,UNC Wilmington,67,,9,8,
41,16-Mar-02,2002,2001-02,2,West,20.54,13,3,Arizona,68,11.01,67,11,Wyoming,60,,8,8,
42,17-Mar-02,2002,2001-02,2,East,18.44,25,3,Georgia,75,13.45,49,11,Southern Illinois,77,,2,-8,11 over 3
43,17-Mar-02,2002,2001-02,2,West,30.19,2,1,Cincinnati,101,16.34,35,8,UCLA,105,2 OT,4,-7,8 over 1
44,17-Mar-02,2002,2001-02,2,East,29.25,3,1,Maryland,87,13.22,50,8,Wisconsin,57,,30,7,
45,17-Mar-02,2002,2001-02,2,East,19.36,18,2,Connecticut,77,19.15,21,7,North Carolina St.,74,,3,5,
46,17-Mar-02,2002,2001-02,2,Midwest,23.21,8,4,Illinois,72,11.82,59,12,Creighton,60,,12,8,
47,17-Mar-02,2002,2001-02,2,South,19.94,16,3,Pittsburgh,63,16.03,37,6,California,50,,13,3,
48,17-Mar-02,2002,2001-02,2,West,26.04,5,2,Oklahoma,78,18.6,23,7,Xavier,65,,13,5,
49,17-Mar-02,2002,2001-02,2,Midwest,18.25,26,3,Mississippi St.,64,17.69,27,6,Texas,68,,4,-3,6 over 3
50,21-Mar-02,2002,2001-02,3,South,20.39,14,10,Kent St.,78,19.94,16,3,Pittsburgh,73,,5,-7,10 over 3
51,21-Mar-02,2002,2001-02,3,South,34.19,1,1,Duke,73,24.8,6,5,Indiana,74,,1,-4,5 over 1
52,21-Mar-02,2002,2001-02,3,West,17.49,29,12,Missouri,82,16.34,35,8,UCLA,73,,9,-4,12 over 8
53,21-Mar-02,2002,2001-02,3,West,26.04,5,2,Oklahoma,88,20.54,13,3,Arizona,67,,21,1,
54,22-Mar-02,2002,2001-02,3,East,29.25,3,1,Maryland,78,22.21,10,4,Kentucky,68,,10,3,
55,22-Mar-02,2002,2001-02,3,East,19.36,18,2,Connecticut,71,13.45,49,11,Southern Illinois,59,,12,9,
56,22-Mar-02,2002,2001-02,3,Midwest,28.99,4,1,Kansas,73,23.21,8,4,Illinois,69,,4,3,
57,22-Mar-02,2002,2001-02,3,Midwest,22.97,9,2,Oregon,72,17.69,27,6,Texas,70,,2,4,
58,23-Mar-02,2002,2001-02,4,South,24.8,6,5,Indiana,81,20.39,14,10,Kent St.,69,,12,5,
59,23-Mar-02,2002,2001-02,4,West,26.04,5,2,Oklahoma,81,17.49,29,12,Missouri,75,,6,10,
60,24-Mar-02,2002,2001-02,4,East,29.25,3,1,Maryland,90,19.36,18,2,Connecticut,82,,8,1,
61,24-Mar-02,2002,2001-02,4,Midwest,28.99,4,1,Kansas,104,22.97,9,2,Oregon,86,,18,1,
62,30-Mar-02,2002,2001-02,5,Final Four,29.25,3,1,Maryland,97,28.99,4,1,Kansas,88,,9,0,
63,30-Mar-02,2002,2001-02,5,Final Four,26.04,5,2,Oklahoma,64,24.8,6,5,Indiana,73,,9,-3,5 over 2
64,1-Apr-02,2002,2001-02,6,Championship,29.25,3,1,Maryland,64,24.8,6,5,Indiana,52,,12,4,
65,18-Mar-03,2003,2002-03,PI,South,-10.45,260,16,Texas Southern,84,-12.35,283,16,UNC Asheville,92,1 OT,8,0,
66,20-Mar-03,2003,2002-03,1,Midwest,14.53,40,4,Dayton,71,13.04,51,13,Tulsa,84,,13,-9,13 over 4
67,20-Mar-03,2003,2002-03,1,West,17.54,26,6,Creighton,73,10.01,70,11,Central Michigan,79,,6,-5,11 over 6
68,20-Mar-03,2003,2002-03,1,East,23.01,9,1,Oklahoma,71,-8.59,244,16,South Carolina St.,54,,17,15,
69,20-Mar-03,2003,2002-03,1,East,13.59,47,8,California,76,13.18,50,9,North Carolina St.,74,1 OT,2,1,
70,20-Mar-03,2003,2002-03,1,Midwest,21.3,15,3,Marquette,72,10.4,66,14,Holy Cross,68,,4,11,
71,20-Mar-03,2003,2002-03,1,Midwest,22.07,12,5,Wisconsin,81,8.88,76,12,Weber St.,74,,7,7,
72,20-Mar-03,2003,2002-03,1,Midwest,17.32,28,6,Missouri,72,11.76,55,11,Southern Illinois,71,,1,5,
73,20-Mar-03,2003,2002-03,1,South,14.57,39,4,Stanford,77,8.32,80,13,San Diego,69,,8,9,
74,20-Mar-03,2003,2002-03,1,South,19.54,22,5,Connecticut,58,17.68,24,12,BYU,53,,5,7,
75,20-Mar-03,2003,2002-03,1,West,26.8,4,1,Arizona,80,1.57,150,16,Vermont,51,,29,15,
76,20-Mar-03,2003,2002-03,1,West,28.62,2,2,Kansas,64,7.41,88,15,Utah St.,61,,3,13,
77,20-Mar-03,2003,2002-03,1,West,23.75,6,3,Duke,67,5.96,104,14,Colorado St.,57,,10,11,
78,20-Mar-03,2003,2002-03,1,West,24.47,5,4,Illinois,65,11.75,56,13,Western Kentucky,60,,5,9,
79,20-Mar-03,2003,2002-03,1,West,20.31,18,5,Notre Dame,70,12.97,52,12,Milwaukee,69,,1,7,
80,20-Mar-03,2003,2002-03,1,West,16.72,29,7,Memphis,71,16.49,30,10,Arizona St.,84,,13,-3,10 over 7
81,20-Mar-03,2003,2002-03,1,West,15.58,33,9,Gonzaga,74,14.69,36,8,Cincinnati,69,,5,-1,
82,21-Mar-03,2003,2002-03,1,East,21.53,14,5,Mississippi St.,46,16.09,31,12,Butler,47,,1,-7,12 over 5
83,21-Mar-03,2003,2002-03,1,East,19.87,21,2,Wake Forest,76,1.75,147,15,East Tennessee St.,73,,3,13,
84,21-Mar-03,2003,2002-03,1,East,23.28,8,3,Syracuse,76,10.04,68,14,Manhattan,65,,11,11,
85,21-Mar-03,2003,2002-03,1,East,22.75,10,4,Louisville,86,2.65,135,13,Austin Peay,64,,22,9,
86,21-Mar-03,2003,2002-03,1,East,17.67,25,6,Oklahoma St.,77,13.35,48,11,Penn,63,,14,5,
87,21-Mar-03,2003,2002-03,1,Midwest,29.18,1,1,Kentucky,95,0.46,161,16,IUPUI,64,,31,15,
88,21-Mar-03,2003,2002-03,1,Midwest,28.61,3,2,Pittsburgh,87,-1.16,179,15,Wagner,61,,26,13,
89,21-Mar-03,2003,2002-03,1,Midwest,14.6,38,10,Alabama,62,14.48,41,7,Indiana,67,,5,3,
90,21-Mar-03,2003,2002-03,1,South,23.49,7,1,Texas,82,-12.35,283,16,UNC Asheville,61,,21,15,
91,21-Mar-03,2003,2002-03,1,South,22.14,11,2,Florida,85,0.82,157,15,Sam Houston St.,55,,30,13,
92,21-Mar-03,2003,2002-03,1,South,19.88,20,3,Xavier,71,19.88,20,3,Xavier,71,,12,11,
93,21-Mar-03,2003,2002-03,1,South,22,13,6,Maryland,75,14.62,37,11,UNC Wilmington,73,,2,5,
94,21-Mar-03,2003,2002-03,1,South,20.26,19,7,Michigan St.,79,15.27,34,10,Colorado,64,,15,3,
95,21-Mar-03,2003,2002-03,1,East,20.75,17,7,Saint Joseph's,63,13.63,46,10,Auburn,65,1 OT,2,-3,10 over 7
96,21-Mar-03,2003,2002-03,1,Midwest,14.25,42,8,Oregon,58,14.04,44,9,Utah,60,,2,-1,
97,21-Mar-03,2003,2002-03,1,South,18.15,23,8,LSU,56,17.42,27,9,Purdue,80,,24,-1,
98,22-Mar-03,2003,2002-03,2,East,23.01,9,1,Oklahoma,74,13.59,47,8,California,65,,9,7,
99,22-Mar-03,2003,2002-03,2,Midwest,21.3,15,3,Marquette,101,17.32,28,6,Missouri,92,1 OT,9,3,
100,22-Mar-03,2003,2002-03,2,Midwest,22.07,12,5,Wisconsin,61,13.04,51,13,Tulsa,60,,1,8,
101,22-Mar-03,2003,2002-03,2,West,26.8,4,1,Arizona,96,15.58,33,9,Gonzaga,95,2 OT,1,8,
102,22-Mar-03,2003,2002-03,2,West,28.62,2,2,Kansas,108,16.49,30,10,Arizona St.,76,,32,8,
103,22-Mar-03,2003,2002-03,2,West,23.75,6,3,Duke,86,10.01,70,11,Central Michigan,60,,26,8,
104,22-Mar-03,2003,2002-03,2,South,19.54,22,5,Connecticut,85,14.57,39,4,Stanford,74,,11,-1,
105,22-Mar-03,2003,2002-03,2,West,24.47,5,4,Illinois,60,20.31,18,5,Notre Dame,68,,8,-1,
106,23-Mar-03,2003,2002-03,2,East,19.87,21,2,Wake Forest,62,13.63,46,10,Auburn,68,,6,-8,10 over 2
107,23-Mar-03,2003,2002-03,2,East,22.75,10,4,Louisville,71,16.09,31,12,Butler,79,,8,-8,12 over 4
108,23-Mar-03,2003,2002-03,2,South,22.14,11,2,Florida,46,20.26,19,7,Michigan St.,68,,22,-5,7 over 2
109,23-Mar-03,2003,2002-03,2,East,23.28,8,3,Syracuse,68,17.67,25,6,Oklahoma St.,56,,12,3,
110,23-Mar-03,2003,2002-03,2,Midwest,29.18,1,1,Kentucky,74,14.04,44,9,Utah,54,,20,8,
111,23-Mar-03,2003,2002-03,2,Midwest,28.61,3,2,Pittsburgh,74,14.48,41,7,Indiana,52,,22,5,
112,23-Mar-03,2003,2002-03,2,South,23.49,7,1,Texas,77,17.42,27,9,Purdue,67,,10,8,
113,23-Mar-03,2003,2002-03,2,South,22,13,6,Maryland,77,19.88,20,3,Xavier,64,,13,-3,6 over 3
114,27-Mar-03,2003,2002-03,3,Midwest,29.18,1,1,Kentucky,63,22.07,12,5,Wisconsin,57,,6,4,
115,27-Mar-03,2003,2002-03,3,West,26.8,4,1,Arizona,88,20.31,18,5,Notre Dame,71,,17,4,
116,27-Mar-03,2003,2002-03,3,West,28.62,2,2,Kansas,69,23.75,6,3,Duke,65,,4,1,
117,27-Mar-03,2003,2002-03,3,Midwest,28.61,3,2,Pittsburgh,74,21.3,15,3,Marquette,77,,3,-1,
118,28-Mar-03,2003,2002-03,3,East,23.01,9,1,Oklahoma,65,16.09,31,12,Butler,54,,11,11,
119,28-Mar-03,2003,2002-03,3,East,23.28,8,3,Syracuse,79,13.63,46,10,Auburn,78,,1,7,
120,28-Mar-03,2003,2002-03,3,South,23.49,7,1,Texas,82,19.54,22,5,Connecticut,78,,4,4,
121,28-Mar-03,2003,2002-03,3,South,22,13,6,Maryland,58,20.26,19,7,Michigan St.,60,,2,-1,
122,29-Mar-03,2003,2002-03,4,Midwest,29.18,1,1,Kentucky,69,21.3,15,3,Marquette,83,,14,-2,
123,29-Mar-03,2003,2002-03,4,West,28.62,2,2,Kansas,78,26.8,4,1,Arizona,75,,3,-1,
124,30-Mar-03,2003,2002-03,4,South,23.49,7,1,Texas,85,20.26,19,7,Michigan St.,76,,9,6,
125,30-Mar-03,2003,2002-03,4,East,23.28,8,3,Syracuse,63,23.01,9,1,Oklahoma,47,,16,-2,
126,5-Apr-03,2003,2002-03,5,Final Four,28.62,2,2,Kansas,94,21.3,15,3,Marquette,61,,33,1,
127,5-Apr-03,2003,2002-03,5,Final Four,23.49,7,1,Texas,84,23.28,8,3,Syracuse,95,,11,-2,
128,7-Apr-03,2003,2002-03,6,Championship,28.62,2,2,Kansas,78,23.28,8,3,Syracuse,81,,3,-1,
129,16-Mar-04,2004,2003-04,PI,Midwest,-7.01,240,16,Lehigh,57,-9.35,256,16,Florida A&M,72,,15,0,
130,18-Mar-04,2004,2003-04,1,East,18.26,25,5,Florida,60,13.38,48,12,Manhattan,75,,15,-7,12 over 5
131,18-Mar-04,2004,2003-04,1,East,27.66,3,1,Saint Joseph's,82,-2.5,181,16,Liberty,63,,19,15,
132,18-Mar-04,2004,2003-04,1,East,21.69,15,4,Wake Forest,79,9.09,81,13,VCU,78,,1,9,
133,18-Mar-04,2004,2003-04,1,East,17.11,28,8,Texas Tech,76,14.25,43,9,Charlotte,73,,3,1,
134,18-Mar-04,2004,2003-04,1,Midwest,25.34,7,2,Gonzaga,76,0.53,152,15,Valparaiso,49,,27,13,
135,18-Mar-04,2004,2003-04,1,South,32.33,1,1,Duke,96,-10.72,266,16,Alabama St.,61,,35,15,
136,18-Mar-04,2004,2003-04,1,South,21.54,17,3,Texas,66,4.86,108,14,Princeton,49,,17,11,
137,18-Mar-04,2004,2003-04,1,South,23.23,11,6,North Carolina,63,15.42,36,11,Air Force,52,,11,5,
138,18-Mar-04,2004,2003-04,1,South,17.35,27,8,Seton Hall,80,16.18,32,9,Arizona,76,,4,1,
139,18-Mar-04,2004,2003-04,1,West,22.52,12,1,Stanford,71,-7.69,248,16,UTSA,45,,26,15,
140,18-Mar-04,2004,2003-04,1,West,28.3,2,2,Connecticut,70,-1.37,172,15,Vermont,53,,17,13,
141,18-Mar-04,2004,2003-04,1,West,19.81,22,4,Maryland,86,14.69,41,13,UTEP,83,,3,9,
142,18-Mar-04,2004,2003-04,1,West,16.34,30,5,Syracuse,80,15.64,35,12,BYU,75,,5,7,
143,18-Mar-04,2004,2003-04,1,West,11.36,58,7,DePaul,76,9.75,74,10,Dayton,69,2 OT,7,3,
144,18-Mar-04,2004,2003-04,1,West,16.5,29,8,Alabama,65,14.33,42,9,Southern Illinois,64,,1,1,
145,18-Mar-04,2004,2003-04,1,Midwest,20.27,20,10,Nevada,72,15.66,34,7,Michigan St.,66,,6,-3,10 over 7
146,19-Mar-04,2004,2003-04,1,Midwest,18.32,24,5,Providence,58,8.93,82,12,Pacific,66,,8,-7,12 over 5
147,19-Mar-04,2004,2003-04,1,East,27.37,4,2,Oklahoma St.,75,3.09,125,15,Eastern Washington,56,,19,13,
148,19-Mar-04,2004,2003-04,1,East,25.91,5,3,Pittsburgh,53,5.91,98,14,UCF,44,,9,11,
149,19-Mar-04,2004,2003-04,1,East,25.74,6,6,Wisconsin,76,15.07,38,11,Richmond,64,,12,5,
150,19-Mar-04,2004,2003-04,1,East,16.17,33,7,Memphis,59,15.02,39,10,South Carolina,43,,16,3,
151,19-Mar-04,2004,2003-04,1,Midwest,23.35,10,1,Kentucky,96,-9.35,256,16,Florida A&M,76,,20,15,
152,19-Mar-04,2004,2003-04,1,Midwest,24.69,8,3,Georgia Tech,65,8.78,84,14,Northern Iowa,60,,5,11,
153,19-Mar-04,2004,2003-04,1,Midwest,20.89,18,4,Kansas,78,10.39,63,13,Illinois Chicago,53,,25,9,
154,19-Mar-04,2004,2003-04,1,Midwest,15.42,37,6,Boston College,58,14.13,45,11,Utah,51,,7,5,
155,19-Mar-04,2004,2003-04,1,South,21.74,14,2,Mississippi St.,85,-3.99,194,15,Monmouth,52,,33,13,
156,19-Mar-04,2004,2003-04,1,South,21.56,16,4,Cincinnati,80,8.6,85,13,East Tennessee St.,77,,3,9,
157,19-Mar-04,2004,2003-04,1,South,22.11,13,5,Illinois,72,10.62,61,12,Murray St.,53,,19,7,
158,19-Mar-04,2004,2003-04,1,South,20.44,19,10,Louisville,70,20.16,21,7,Xavier,80,,10,3,
159,19-Mar-04,2004,2003-04,1,West,23.98,9,3,North Carolina St.,61,-5.28,218,14,Lafayette,52,,9,11,
160,19-Mar-04,2004,2003-04,1,West,18.64,23,6,Vanderbilt,71,16.29,31,11,Western Michigan,58,,13,5,
161,19-Mar-04,2004,2003-04,1,Midwest,13.63,46,9,UAB,102,10.78,60,8,Washington,100,,2,-1,
162,20-Mar-04,2004,2003-04,2,Midwest,25.34,7,2,Gonzaga,72,20.27,20,10,Nevada,91,,19,-8,10 over 2
163,20-Mar-04,2004,2003-04,2,West,22.52,12,1,Stanford,67,16.5,29,8,Alabama,70,,3,-7,8 over 1
164,20-Mar-04,2004,2003-04,2,East,27.66,3,1,Saint Joseph's,70,17.11,28,8,Texas Tech,65,,5,7,
165,20-Mar-04,2004,2003-04,2,East,21.69,15,4,Wake Forest,84,13.38,48,12,Manhattan,80,,4,8,
166,20-Mar-04,2004,2003-04,2,South,32.33,1,1,Duke,90,17.35,27,8,Seton Hall,62,,28,7,
167,20-Mar-04,2004,2003-04,2,South,23.23,11,6,North Carolina,75,21.54,17,3,Texas,78,,3,3,
168,20-Mar-04,2004,2003-04,2,West,28.3,2,2,Connecticut,72,11.36,58,7,DePaul,55,,17,5,
169,20-Mar-04,2004,2003-04,2,West,19.81,22,4,Maryland,70,16.34,30,5,Syracuse,72,,2,-1,
170,21-Mar-04,2004,2003-04,2,Midwest,23.35,10,1,Kentucky,75,13.63,46,9,UAB,76,,1,-8,9 over 1
171,21-Mar-04,2004,2003-04,2,South,21.74,14,2,Mississippi St.,74,20.16,21,7,Xavier,89,,15,-5,7 over 2
172,21-Mar-04,2004,2003-04,2,East,27.37,4,2,Oklahoma St.,70,16.17,33,7,Memphis,53,,17,5,
173,21-Mar-04,2004,2003-04,2,East,25.91,5,3,Pittsburgh,59,25.74,6,6,Wisconsin,55,,4,3,
174,21-Mar-04,2004,2003-04,2,Midwest,24.69,8,3,Georgia Tech,57,15.42,37,6,Boston College,54,,3,3,
175,21-Mar-04,2004,2003-04,2,Midwest,20.89,18,4,Kansas,78,8.93,82,12,Pacific,63,,15,8,
176,21-Mar-04,2004,2003-04,2,West,23.98,9,3,North Carolina St.,73,18.64,23,6,Vanderbilt,75,,2,-3,6 over 3
177,21-Mar-04,2004,2003-04,2,South,22.11,13,5,Illinois,92,21.56,16,4,Cincinnati,68,,24,-1,
178,25-Mar-04,2004,2003-04,3,East,27.66,3,1,Saint Joseph's,84,21.69,15,4,Wake Forest,80,,4,3,
179,25-Mar-04,2004,2003-04,3,East,27.37,4,2,Oklahoma St.,63,25.91,5,3,Pittsburgh,51,,12,1,
180,25-Mar-04,2004,2003-04,3,West,28.3,2,2,Connecticut,73,18.64,23,6,Vanderbilt,53,,20,4,
181,25-Mar-04,2004,2003-04,3,West,16.5,29,8,Alabama,80,16.34,30,5,Syracuse,71,,9,-3,8 over 5
182,26-Mar-04,2004,2003-04,3,South,21.54,17,3,Texas,71,20.16,21,7,Xavier,79,,8,-4,7 over 3
183,26-Mar-04,2004,2003-04,3,Midwest,24.69,8,3,Georgia Tech,72,20.27,20,10,Nevada,67,,5,7,
184,26-Mar-04,2004,2003-04,3,Midwest,20.89,18,4,Kansas,100,13.63,46,9,UAB,74,,26,5,
185,26-Mar-04,2004,2003-04,3,South,32.33,1,1,Duke,72,22.11,13,5,Illinois,62,,10,4,
186,27-Mar-04,2004,2003-04,4,West,28.3,2,2,Connecticut,87,16.5,29,8,Alabama,71,,16,6,
187,27-Mar-04,2004,2003-04,4,East,27.66,3,1,Saint Joseph's,62,27.37,4,2,Oklahoma St.,64,,2,-1,
188,28-Mar-04,2004,2003-04,4,Midwest,24.69,8,3,Georgia Tech,79,20.89,18,4,Kansas,71,1 OT,8,1,
189,28-Mar-04,2004,2003-04,4,South,32.33,1,1,Duke,66,20.16,21,7,Xavier,63,,3,6,
190,3-Apr-04,2004,2003-04,5,Final Four,32.33,1,1,Duke,78,28.3,2,2,Connecticut,79,,1,-1,
191,3-Apr-04,2004,2003-04,5,Final Four,27.37,4,2,Oklahoma St.,65,24.69,8,3,Georgia Tech,67,,2,-1,
192,5-Apr-04,2004,2003-04,6,Championship,28.3,2,2,Connecticut,82,24.69,8,3,Georgia Tech,73,,9,1,
193,15-Mar-05,2005,2004-05,PI,East,-1.2,178,16,Oakland,79,-12.49,278,16,Alabama A&M,69,,10,0,
194,17-Mar-05,2005,2004-05,1,Midwest,20.51,18,5,Alabama,73,14.69,36,12,Milwaukee,83,,10,-7,12 over 5
195,17-Mar-05,2005,2004-05,1,Midwest,13.8,42,6,LSU,68,12.51,51,11,UAB,82,,14,-5,11 over 6
196,17-Mar-05,2005,2004-05,1,Midwest,32.68,2,1,Illinois,67,-2.52,190,16,Fairleigh Dickinson,55,,12,15,
197,17-Mar-05,2005,2004-05,1,Midwest,22.22,13,3,Arizona,66,19.62,21,14,Utah St.,53,,13,11,
198,17-Mar-05,2005,2004-05,1,Midwest,18.3,25,4,Boston College,85,9.6,77,13,Penn,65,,20,9,
199,17-Mar-05,2005,2004-05,1,South,24.1,9,2,Kentucky,72,1.98,143,15,Eastern Kentucky,64,,8,13,
200,17-Mar-05,2005,2004-05,1,South,22.55,12,3,Oklahoma,84,5.43,106,14,Niagara,67,,17,11,
201,17-Mar-05,2005,2004-05,1,South,20.33,20,6,Utah,60,11.62,58,11,UTEP,54,,6,5,
202,17-Mar-05,2005,2004-05,1,South,20.43,19,7,Cincinnati,76,17.17,27,10,Iowa,64,,12,3,
203,17-Mar-05,2005,2004-05,1,West,22.18,14,1,Washington,88,-2.73,194,16,Montana,77,,11,15,
204,17-Mar-05,2005,2004-05,1,West,24.86,8,2,Wake Forest,70,0.03,165,15,Chattanooga,54,,16,13,
205,17-Mar-05,2005,2004-05,1,West,17.88,26,3,Gonzaga,74,4.97,108,14,Winthrop,64,,10,11,
206,17-Mar-05,2005,2004-05,1,West,15.47,32,6,Texas Tech,78,10.74,68,11,UCLA,66,,12,5,
207,17-Mar-05,2005,2004-05,1,West,15,35,7,West Virginia,63,14.33,39,10,Creighton,61,,2,3,
208,17-Mar-05,2005,2004-05,1,West,18.41,24,9,Pittsburgh,71,14.08,40,8,Pacific,79,,8,1,
209,17-Mar-05,2005,2004-05,1,Midwest,17.01,28,8,Texas,57,12.11,55,9,Nevada,61,,4,-1,
210,18-Mar-05,2005,2004-05,1,East,23.08,11,3,Kansas,63,6.69,95,14,Bucknell,64,,1,-11,14 over 3
211,18-Mar-05,2005,2004-05,1,South,20.98,16,4,Syracuse,57,13.53,43,13,Vermont,60,1 OT,3,-9,13 over 4
212,18-Mar-05,2005,2004-05,1,East,32.77,1,1,North Carolina,96,-1.2,178,16,Oakland,68,,28,15,
213,18-Mar-05,2005,2004-05,1,East,21.94,15,2,Connecticut,77,-2.56,192,15,UCF,71,,6,13,
214,18-Mar-05,2005,2004-05,1,East,23.93,10,4,Florida,67,8.29,85,13,Ohio,62,,5,9,
215,18-Mar-05,2005,2004-05,1,East,25.02,7,5,Villanova,55,15.54,31,12,New Mexico,47,,8,7,
216,18-Mar-05,2005,2004-05,1,East,20.81,17,6,Wisconsin,57,13.36,45,11,Northern Iowa,52,,5,5,
217,18-Mar-05,2005,2004-05,1,Midwest,25.02,6,2,Oklahoma St.,63,3.2,134,15,Southeastern Louisiana,50,,13,13,
218,18-Mar-05,2005,2004-05,1,Midwest,16.75,29,7,Southern Illinois,65,9.41,78,10,Saint Mary's,56,,9,3,
219,18-Mar-05,2005,2004-05,1,South,27.41,3,1,Duke,57,-4.95,209,16,Delaware St.,46,,11,15,
220,18-Mar-05,2005,2004-05,1,South,25.67,5,5,Michigan St.,89,10.04,73,12,Old Dominion,81,,8,7,
221,18-Mar-05,2005,2004-05,1,West,25.78,4,4,Louisville,68,-12.19,275,13,Lafayette,62,,6,9,
222,18-Mar-05,2005,2004-05,1,West,19.23,22,5,Georgia Tech,80,14.41,38,12,George Washington,68,,12,7,
223,18-Mar-05,2005,2004-05,1,East,18.93,23,10,North Carolina St.,75,12.15,54,7,Charlotte,63,,12,-3,10 over 7
224,18-Mar-05,2005,2004-05,1,East,14.06,41,8,Minnesota,53,13.02,48,9,Iowa St.,64,,11,-1,
225,18-Mar-05,2005,2004-05,1,South,15.25,34,9,Mississippi St.,93,10.63,69,8,Stanford,70,,23,-1,
226,19-Mar-05,2005,2004-05,2,Midwest,18.3,25,4,Boston College,75,14.69,36,12,Milwaukee,83,,8,-8,12 over 4
227,19-Mar-05,2005,2004-05,2,West,24.86,8,2,Wake Forest,105,15,35,7,West Virginia,111,2 OT,6,-5,7 over 2
228,19-Mar-05,2005,2004-05,2,Midwest,32.68,2,1,Illinois,71,12.11,55,9,Nevada,59,,12,8,
229,19-Mar-05,2005,2004-05,2,Midwest,22.22,13,3,Arizona,85,12.51,51,11,UAB,63,,22,8,
230,19-Mar-05,2005,2004-05,2,South,24.1,9,2,Kentucky,69,20.43,19,7,Cincinnati,60,,9,5,
231,19-Mar-05,2005,2004-05,2,West,22.18,14,1,Washington,97,14.08,40,8,Pacific,79,,18,7,
232,19-Mar-05,2005,2004-05,2,South,22.55,12,3,Oklahoma,58,20.33,20,6,Utah,67,,9,-3,6 over 3
233,19-Mar-05,2005,2004-05,2,West,17.88,26,3,Gonzaga,69,15.47,32,6,Texas Tech,71,,2,-3,6 over 3
234,20-Mar-05,2005,2004-05,2,East,21.94,15,2,Connecticut,62,18.93,23,10,North Carolina St.,65,,3,-8,10 over 2
235,20-Mar-05,2005,2004-05,2,East,32.77,1,1,North Carolina,92,13.02,48,9,Iowa St.,65,,27,8,
236,20-Mar-05,2005,2004-05,2,East,20.81,17,6,Wisconsin,71,6.69,95,14,Bucknell,62,,9,8,
237,20-Mar-05,2005,2004-05,2,Midwest,25.02,6,2,Oklahoma St.,85,16.75,29,7,Southern Illinois,77,,8,5,
238,20-Mar-05,2005,2004-05,2,South,27.41,3,1,Duke,63,15.25,34,9,Mississippi St.,55,,8,8,
239,20-Mar-05,2005,2004-05,2,South,25.67,5,5,Michigan St.,72,13.53,43,13,Vermont,61,,11,8,
240,20-Mar-05,2005,2004-05,2,West,25.78,4,4,Louisville,76,19.23,22,5,Georgia Tech,54,,22,1,
241,20-Mar-05,2005,2004-05,2,East,25.02,7,5,Villanova,76,23.93,10,4,Florida,65,,11,-1,
242,24-Mar-05,2005,2004-05,3,Midwest,32.68,2,1,Illinois,77,14.69,36,12,Milwaukee,63,,14,11,
243,24-Mar-05,2005,2004-05,3,West,25.78,4,4,Louisville,93,22.18,14,1,Washington,79,,14,-3,4 over 1
244,24-Mar-05,2005,2004-05,3,Midwest,25.02,6,2,Oklahoma St.,78,22.22,13,3,Arizona,79,,1,-1,
245,24-Mar-05,2005,2004-05,3,West,15.47,32,6,Texas Tech,60,15,35,7,West Virginia,65,,5,-1,
246,25-Mar-05,2005,2004-05,3,South,27.41,3,1,Duke,68,25.67,5,5,Michigan St.,78,,10,-4,5 over 1
247,25-Mar-05,2005,2004-05,3,East,32.77,1,1,North Carolina,67,25.02,7,5,Villanova,66,,1,4,
248,25-Mar-05,2005,2004-05,3,East,20.81,17,6,Wisconsin,65,18.93,23,10,North Carolina St.,56,,9,4,
249,25-Mar-05,2005,2004-05,3,South,24.1,9,2,Kentucky,62,20.33,20,6,Utah,52,,10,4,
250,26-Mar-05,2005,2004-05,4,Midwest,32.68,2,1,Illinois,90,22.22,13,3,Arizona,89,1 OT,1,2,
251,26-Mar-05,2005,2004-05,4,West,25.78,4,4,Louisville,93,15,35,7,West Virginia,85,1 OT,8,3,
252,27-Mar-05,2005,2004-05,4,South,25.67,5,5,Michigan St.,94,24.1,9,2,Kentucky,88,2 OT,6,-3,5 over 2
253,27-Mar-05,2005,2004-05,4,East,32.77,1,1,North Carolina,88,20.81,17,6,Wisconsin,82,,6,5,
254,2-Apr-05,2005,2004-05,5,Final Four,32.77,1,1,North Carolina,87,25.67,5,5,Michigan St.,71,,16,4,
255,2-Apr-05,2005,2004-05,5,Final Four,32.68,2,1,Illinois,72,25.78,4,4,Louisville,57,,15,3,
256,4-Apr-05,2005,2004-05,6,Championship,32.77,1,1,North Carolina,75,32.68,2,1,Illinois,70,,5,0,
257,14-Mar-06,2006,2005-06,PI,Midwest,-0.68,164,16,Monmouth,71,-10.4,271,16,Hampton,49,,22,0,
258,16-Mar-06,2006,2005-06,1,Midwest,15.22,37,5,Nevada,79,8.95,87,12,Montana,87,,8,-7,12 over 5
259,16-Mar-06,2006,2005-06,1,South,15.9,31,12,Texas A&M,66,13.15,50,5,Syracuse,58,,8,-7,12 over 5
260,16-Mar-06,2006,2005-06,1,Midwest,13.99,45,6,Oklahoma,74,11.86,62,11,Milwaukee,82,,8,-5,11 over 6
261,16-Mar-06,2006,2005-06,1,West,15.36,36,7,Marquette,85,12.48,60,10,Alabama,90,,5,-3,10 over 7
262,16-Mar-06,2006,2005-06,1,East,19.44,17,2,Tennessee,63,10.27,73,15,Winthrop,61,,2,13,
263,16-Mar-06,2006,2005-06,1,East,23.2,9,4,Illinois,78,14.87,40,13,Air Force,69,,9,9,
264,16-Mar-06,2006,2005-06,1,East,20.09,15,5,Washington,75,10.86,69,12,Utah St.,61,,14,7,
265,16-Mar-06,2006,2005-06,1,East,16.06,26,7,Wichita St.,86,9.06,86,10,Seton Hall,66,,20,3,
266,16-Mar-06,2006,2005-06,1,Midwest,28.28,1,3,Florida,76,9.28,84,14,South Alabama,50,,26,11,
267,16-Mar-06,2006,2005-06,1,Midwest,18.65,18,4,Boston College,88,10.87,68,13,Pacific,76,2 OT,12,9,
268,16-Mar-06,2006,2005-06,1,South,27.54,2,1,Duke,70,-3.4,197,16,Southern,54,,16,15,
269,16-Mar-06,2006,2005-06,1,South,22,11,4,LSU,80,11.33,65,13,Iona,64,,16,9,
270,16-Mar-06,2006,2005-06,1,South,14.77,42,9,UNC Wilmington,85,14.67,43,8,George Washington,88,1 OT,3,1,
271,16-Mar-06,2006,2005-06,1,West,23.4,7,2,UCLA,78,-0.73,165,15,Belmont,44,,34,13,
272,16-Mar-06,2006,2005-06,1,West,15.64,33,3,Gonzaga,79,12.73,54,14,Xavier,75,,4,11,
273,16-Mar-06,2006,2005-06,1,West,15.53,34,6,Indiana,87,12.78,52,11,San Diego St.,83,,4,5,
274,17-Mar-06,2006,2005-06,1,South,18.22,21,3,Iowa,63,7.51,93,14,Northwestern St.,64,,1,-11,14 over 3
275,17-Mar-06,2006,2005-06,1,West,23.22,8,4,Kansas,73,16.5,25,13,Bradley,77,,4,-9,13 over 4
276,17-Mar-06,2006,2005-06,1,East,18.16,22,11,George Mason,75,16.02,27,6,Michigan St.,65,,10,-5,11 over 6
277,17-Mar-06,2006,2005-06,1,South,15.92,30,10,North Carolina St.,58,13.68,47,7,California,52,,6,-3,10 over 7
278,17-Mar-06,2006,2005-06,1,East,25.44,4,1,Connecticut,72,2.63,138,16,Albany,59,,13,15,
279,17-Mar-06,2006,2005-06,1,East,22.16,10,3,North Carolina,69,8.56,89,14,Murray St.,65,,4,11,
280,17-Mar-06,2006,2005-06,1,East,17.13,24,8,Kentucky,69,12.65,56,9,UAB,64,,5,1,
281,17-Mar-06,2006,2005-06,1,Midwest,24.59,5,1,Villanova,58,-0.68,164,16,Monmouth,45,,13,15,
282,17-Mar-06,2006,2005-06,1,Midwest,20.68,14,2,Ohio St.,70,4.86,122,15,Davidson,62,,8,13,
283,17-Mar-06,2006,2005-06,1,Midwest,21.29,13,7,Georgetown,54,15.84,32,10,Northern Iowa,49,,5,3,
284,17-Mar-06,2006,2005-06,1,Midwest,17.23,23,8,Arizona,94,14.94,39,9,Wisconsin,75,,19,1,
285,17-Mar-06,2006,2005-06,1,South,25.79,3,2,Texas,60,7.3,97,15,Penn,52,,8,13,
286,17-Mar-06,2006,2005-06,1,South,19.49,16,6,West Virginia,64,13.6,48,11,Southern Illinois,46,,18,5,
287,17-Mar-06,2006,2005-06,1,West,23.54,6,1,Memphis,94,5.7,112,16,Oral Roberts,78,,16,15,
288,17-Mar-06,2006,2005-06,1,West,21.72,12,5,Pittsburgh,79,10.54,70,12,Kent St.,64,,15,7,
289,17-Mar-06,2006,2005-06,1,West,18.47,20,8,Arkansas,55,12.56,58,9,Bucknell,59,,4,-1,
290,18-Mar-06,2006,2005-06,2,East,19.44,17,2,Tennessee,73,16.06,26,7,Wichita St.,80,,7,-5,7 over 2
291,18-Mar-06,2006,2005-06,2,Midwest,28.28,1,3,Florida,82,11.86,62,11,Milwaukee,60,,22,8,
292,18-Mar-06,2006,2005-06,2,Midwest,18.65,18,4,Boston College,69,8.95,87,12,Montana,56,,13,8,
293,18-Mar-06,2006,2005-06,2,South,27.54,2,1,Duke,74,14.67,43,8,George Washington,61,,13,7,
294,18-Mar-06,2006,2005-06,2,South,22,11,4,LSU,58,15.9,31,12,Texas A&M,57,,1,8,
295,18-Mar-06,2006,2005-06,2,West,23.4,7,2,UCLA,62,12.48,60,10,Alabama,59,,3,8,
296,18-Mar-06,2006,2005-06,2,West,15.64,33,3,Gonzaga,90,15.53,34,6,Indiana,80,,10,3,
297,18-Mar-06,2006,2005-06,2,East,23.2,9,4,Illinois,64,20.09,15,5,Washington,67,,3,-1,
298,19-Mar-06,2006,2005-06,2,East,22.16,10,3,North Carolina,60,18.16,22,11,George Mason,65,,5,-8,11 over 3
299,19-Mar-06,2006,2005-06,2,West,21.72,12,5,Pittsburgh,66,16.5,25,13,Bradley,72,,6,-8,13 over 5
300,19-Mar-06,2006,2005-06,2,Midwest,21.29,13,7,Georgetown,70,20.68,14,2,Ohio St.,52,,18,-5,7 over 2
301,19-Mar-06,2006,2005-06,2,East,25.44,4,1,Connecticut,87,17.13,24,8,Kentucky,83,,4,7,
302,19-Mar-06,2006,2005-06,2,Midwest,24.59,5,1,Villanova,82,17.23,23,8,Arizona,78,,4,7,
303,19-Mar-06,2006,2005-06,2,South,25.79,3,2,Texas,75,15.92,30,10,North Carolina St.,54,,21,8,
304,19-Mar-06,2006,2005-06,2,South,19.49,16,6,West Virginia,67,7.51,93,14,Northwestern St.,54,,13,8,
305,19-Mar-06,2006,2005-06,2,West,23.54,6,1,Memphis,72,12.56,58,9,Bucknell,56,,16,8,
306,23-Mar-06,2006,2005-06,3,South,27.54,2,1,Duke,54,22,11,4,LSU,62,,8,-3,4 over 1
307,23-Mar-06,2006,2005-06,3,South,25.79,3,2,Texas,74,19.49,16,6,West Virginia,71,,3,4,
308,23-Mar-06,2006,2005-06,3,West,23.54,6,1,Memphis,80,16.5,25,13,Bradley,64,,16,12,
309,23-Mar-06,2006,2005-06,3,West,23.4,7,2,UCLA,73,15.64,33,3,Gonzaga,71,,2,1,
310,24-Mar-06,2006,2005-06,3,East,18.16,22,11,George Mason,63,16.06,26,7,Wichita St.,55,,8,-4,11 over 7
311,24-Mar-06,2006,2005-06,3,East,25.44,4,1,Connecticut,98,20.09,15,5,Washington,92,1 OT,6,4,
312,24-Mar-06,2006,2005-06,3,Midwest,24.59,5,1,Villanova,60,18.65,18,4,Boston College,59,1 OT,1,3,
313,24-Mar-06,2006,2005-06,3,Midwest,28.28,1,3,Florida,57,21.29,13,7,Georgetown,53,,4,4,
314,25-Mar-06,2006,2005-06,4,South,25.79,3,2,Texas,60,22,11,4,LSU,70,1 OT,10,-2,
315,25-Mar-06,2006,2005-06,4,West,23.54,6,1,Memphis,45,23.4,7,2,UCLA,50,,5,-1,
316,26-Mar-06,2006,2005-06,4,East,25.44,4,1,Connecticut,84,18.16,22,11,George Mason,86,1 OT,2,-10,11 over 1
317,26-Mar-06,2006,2005-06,4,Midwest,28.28,1,3,Florida,75,24.59,5,1,Villanova,62,,13,-2,
318,1-Apr-06,2006,2005-06,5,Final Four,23.4,7,2,UCLA,59,22,11,4,LSU,45,,14,2,
319,1-Apr-06,2006,2005-06,5,Final Four,28.28,1,3,Florida,73,18.16,22,11,George Mason,58,,15,8,
320,3-Apr-06,2006,2005-06,6,Championship,28.28,1,3,Florida,73,23.4,7,2,UCLA,57,,16,-1,
321,13-Mar-07,2007,2006-07,PI,West,-2.76,186,16,Niagara,77,-9.57,254,16,Florida A&M,69,,8,0,
322,15-Mar-07,2007,2006-07,1,West,23.3,10,6,Duke,77,14.55,52,11,VCU,79,,2,-5,11 over 6
323,15-Mar-07,2007,2006-07,1,East,31.37,1,1,North Carolina,86,-2.58,182,16,Eastern Kentucky,65,,21,15,
324,15-Mar-07,2007,2006-07,1,East,28.48,4,2,Georgetown,80,4.38,121,15,Belmont,55,,25,13,
325,15-Mar-07,2007,2006-07,1,East,18.87,27,3,Washington St.,70,8.36,88,14,Oral Roberts,54,,16,11,
326,15-Mar-07,2007,2006-07,1,East,16.23,43,6,Vanderbilt,77,7.28,95,11,George Washington,44,,33,5,
327,15-Mar-07,2007,2006-07,1,East,16.18,44,7,Boston College,84,10.98,71,10,Texas Tech,75,,9,3,
328,15-Mar-07,2007,2006-07,1,Midwest,22.42,12,4,Maryland,82,13.32,61,13,Davidson,70,,12,9,
329,15-Mar-07,2007,2006-07,1,Midwest,21.45,15,5,Butler,57,12.7,64,12,Old Dominion,46,,11,7,
330,15-Mar-07,2007,2006-07,1,South,29.33,3,1,Ohio St.,78,-2.24,177,16,Central Connecticut,57,,21,15,
331,15-Mar-07,2007,2006-07,1,South,26.97,7,3,Texas A&M,68,7.69,92,14,Penn,52,,16,11,
332,15-Mar-07,2007,2006-07,1,South,20.35,19,6,Louisville,78,12.37,66,11,Stanford,58,,20,5,
333,15-Mar-07,2007,2006-07,1,West,27.15,6,2,UCLA,70,-2.71,184,15,Weber St.,42,,28,13,
334,15-Mar-07,2007,2006-07,1,West,22.9,11,3,Pittsburgh,79,6.66,100,14,Wright St.,58,,21,11,
335,15-Mar-07,2007,2006-07,1,West,21.58,14,7,Indiana,70,15.31,49,10,Gonzaga,57,,13,3,
336,15-Mar-07,2007,2006-07,1,East,20.97,17,9,Michigan St.,61,17.18,38,8,Marquette,49,,12,-1,
337,15-Mar-07,2007,2006-07,1,South,18.13,32,9,Xavier,79,16.11,46,8,BYU,77,,2,-1,
338,16-Mar-07,2007,2006-07,1,Midwest,20.02,22,6,Notre Dame,64,14.81,51,11,Winthrop,74,,10,-5,11 over 6
339,16-Mar-07,2007,2006-07,1,East,19.24,25,4,Texas,79,7.27,96,13,New Mexico St.,67,,12,9,
340,16-Mar-07,2007,2006-07,1,East,16.86,39,5,USC,77,16.62,42,12,Arkansas,60,,17,7,
341,16-Mar-07,2007,2006-07,1,Midwest,30.81,2,1,Florida,112,-9.48,251,16,Jackson St.,69,,43,15,
342,16-Mar-07,2007,2006-07,1,Midwest,25.45,8,2,Wisconsin,76,7.76,91,15,Texas A&M Corpus Chris,63,,13,13,
343,16-Mar-07,2007,2006-07,1,Midwest,20.76,18,3,Oregon,58,8.38,87,14,Miami OH,56,,2,11,
344,16-Mar-07,2007,2006-07,1,Midwest,19.61,23,10,Georgia Tech,63,16.83,41,7,UNLV,67,,4,3,
345,16-Mar-07,2007,2006-07,1,South,24.81,9,2,Memphis,73,-0.98,162,15,North Texas,58,,15,13,
346,16-Mar-07,2007,2006-07,1,South,15.43,48,4,Virginia,84,2.25,138,13,Albany,57,,27,9,
347,16-Mar-07,2007,2006-07,1,South,18.29,31,5,Tennessee,121,5.44,113,12,Long Beach St.,86,,35,7,
348,16-Mar-07,2007,2006-07,1,South,18.53,28,10,Creighton,71,16.09,47,7,Nevada,77,1 OT,6,3,
349,16-Mar-07,2007,2006-07,1,West,27.81,5,1,Kansas,107,-2.76,186,16,Niagara,67,,40,15,
350,16-Mar-07,2007,2006-07,1,West,21.03,16,4,Southern Illinois,61,7.4,93,13,Holy Cross,51,,10,9,
351,16-Mar-07,2007,2006-07,1,West,17.5,36,12,Illinois,52,17.38,37,5,Virginia Tech,54,,2,7,
352,16-Mar-07,2007,2006-07,1,West,21.73,13,8,Kentucky,67,20.11,21,9,Villanova,58,,9,1,
353,16-Mar-07,2007,2006-07,1,Midwest,19.43,24,8,Arizona,63,18.31,30,9,Purdue,72,,9,-1,
354,17-Mar-07,2007,2006-07,2,East,18.87,27,3,Washington St.,74,16.23,43,6,Vanderbilt,78,2 OT,4,-3,6 over 3
355,17-Mar-07,2007,2006-07,2,East,31.37,1,1,North Carolina,81,20.97,17,9,Michigan St.,67,,14,8,
356,17-Mar-07,2007,2006-07,2,East,28.48,4,2,Georgetown,62,16.18,44,7,Boston College,55,,7,5,
357,17-Mar-07,2007,2006-07,2,South,29.33,3,1,Ohio St.,78,18.13,32,9,Xavier,71,1 OT,7,8,
358,17-Mar-07,2007,2006-07,2,South,26.97,7,3,Texas A&M,72,20.35,19,6,Louisville,69,,3,3,
359,17-Mar-07,2007,2006-07,2,West,27.15,6,2,UCLA,54,21.58,14,7,Indiana,49,,5,5,
360,17-Mar-07,2007,2006-07,2,West,22.9,11,3,Pittsburgh,84,14.55,52,11,VCU,79,1 OT,5,8,
361,17-Mar-07,2007,2006-07,2,Midwest,22.42,12,4,Maryland,59,21.45,15,5,Butler,62,,3,-1,
362,18-Mar-07,2007,2006-07,2,Midwest,25.45,8,2,Wisconsin,68,16.83,41,7,UNLV,74,,6,-5,7 over 2
363,18-Mar-07,2007,2006-07,2,Midwest,30.81,2,1,Florida,74,18.31,30,9,Purdue,67,,7,8,
364,18-Mar-07,2007,2006-07,2,Midwest,20.76,18,3,Oregon,75,14.81,51,11,Winthrop,61,,14,8,
365,18-Mar-07,2007,2006-07,2,South,24.81,9,2,Memphis,78,16.09,47,7,Nevada,62,,16,5,
366,18-Mar-07,2007,2006-07,2,West,27.81,5,1,Kansas,88,21.73,13,8,Kentucky,76,,12,7,
367,18-Mar-07,2007,2006-07,2,West,21.03,16,4,Southern Illinois,63,17.38,37,5,Virginia Tech,48,,15,1,
368,18-Mar-07,2007,2006-07,2,East,19.24,25,4,Texas,68,16.86,39,5,USC,87,,19,-1,
369,18-Mar-07,2007,2006-07,2,South,18.29,31,5,Tennessee,77,15.43,48,4,Virginia,74,,3,-1,
370,22-Mar-07,2007,2006-07,3,South,29.33,3,1,Ohio St.,85,18.29,31,5,Tennessee,84,,1,4,
371,22-Mar-07,2007,2006-07,3,South,26.97,7,3,Texas A&M,64,24.81,9,2,Memphis,65,,1,1,
372,22-Mar-07,2007,2006-07,3,West,27.81,5,1,Kansas,61,21.03,16,4,Southern Illinois,58,,3,3,
373,22-Mar-07,2007,2006-07,3,West,27.15,6,2,UCLA,64,22.9,11,3,Pittsburgh,55,,9,1,
374,23-Mar-07,2007,2006-07,3,East,31.37,1,1,North Carolina,74,16.86,39,5,USC,64,,10,4,
375,23-Mar-07,2007,2006-07,3,East,28.48,4,2,Georgetown,66,16.23,43,6,Vanderbilt,65,,1,4,
376,23-Mar-07,2007,2006-07,3,Midwest,30.81,2,1,Florida,65,21.45,15,5,Butler,57,,8,4,
377,23-Mar-07,2007,2006-07,3,Midwest,20.76,18,3,Oregon,76,16.83,41,7,UNLV,72,,4,4,
378,24-Mar-07,2007,2006-07,4,South,29.33,3,1,Ohio St.,92,24.81,9,2,Memphis,76,,16,1,
379,24-Mar-07,2007,2006-07,4,West,27.81,5,1,Kansas,55,27.15,6,2,UCLA,68,,13,-1,
380,25-Mar-07,2007,2006-07,4,Midwest,30.81,2,1,Florida,85,20.76,18,3,Oregon,77,,8,2,
381,25-Mar-07,2007,2006-07,4,East,31.37,1,1,North Carolina,84,28.48,4,2,Georgetown,96,1 OT,12,-1,
382,31-Mar-07,2007,2006-07,5,Final Four,30.81,2,1,Florida,76,27.15,6,2,UCLA,66,,10,1,
383,31-Mar-07,2007,2006-07,5,Final Four,29.33,3,1,Ohio St.,67,28.48,4,2,Georgetown,60,,7,1,
384,2-Apr-07,2007,2006-07,6,Championship,30.81,2,1,Florida,84,29.33,3,1,Ohio St.,75,,9,0,
385,18-Mar-08,2008,2007-08,PI,East,-1.32,173,16,Mount St. Mary's,69,-14.41,298,16,Coppin St.,60,,9,0,
386,20-Mar-08,2008,2007-08,1,Midwest,18.9,26,11,Kansas St.,80,18.67,28,6,USC,67,,13,-5,11 over 6
387,20-Mar-08,2008,2007-08,1,East,24.32,10,4,Washington St.,71,6.38,104,13,Winthrop,40,,31,9,
388,20-Mar-08,2008,2007-08,1,East,19.07,24,5,Notre Dame,68,9.68,80,12,George Mason,50,,18,7,
389,20-Mar-08,2008,2007-08,1,Midwest,35.21,1,1,Kansas,85,5.4,112,16,Portland St.,61,,24,15,
390,20-Mar-08,2008,2007-08,1,Midwest,26.68,5,3,Wisconsin,71,8.47,88,14,Cal St. Fullerton,56,,15,11,
391,20-Mar-08,2008,2007-08,1,Midwest,13.71,48,8,UNLV,71,13.04,55,9,Kent St.,58,,13,1,
392,20-Mar-08,2008,2007-08,1,South,22.75,12,3,Stanford,77,4.41,123,14,Cornell,53,,24,11,
393,20-Mar-08,2008,2007-08,1,South,19.91,22,4,Pittsburgh,82,10.27,77,13,Oral Roberts,63,,19,9,
394,20-Mar-08,2008,2007-08,1,South,21.15,19,5,Michigan St.,72,12.37,57,12,Temple,61,,11,7,
395,20-Mar-08,2008,2007-08,1,South,22.16,14,6,Marquette,74,10.01,78,11,Kentucky,66,,8,5,
396,20-Mar-08,2008,2007-08,1,West,29.94,4,1,UCLA,70,-15.21,306,16,Mississippi Valley St.,29,,41,15,
397,20-Mar-08,2008,2007-08,1,West,26.4,6,2,Duke,71,3.53,129,15,Belmont,70,,1,13,
398,20-Mar-08,2008,2007-08,1,West,22.05,15,3,Xavier,73,8.08,91,14,Georgia,61,,12,11,
399,20-Mar-08,2008,2007-08,1,West,18.3,30,6,Purdue,90,14.82,41,11,Baylor,79,,11,5,
400,20-Mar-08,2008,2007-08,1,West,21.29,18,7,West Virginia,75,19.14,23,10,Arizona,65,,10,3,
401,20-Mar-08,2008,2007-08,1,West,19.93,21,9,Texas A&M,67,15.76,35,8,BYU,62,,5,-1,
402,21-Mar-08,2008,2007-08,1,Midwest,12.65,56,4,Vanderbilt,62,7.99,93,13,Siena,83,,21,-9,13 over 4
403,21-Mar-08,2008,2007-08,1,West,18.9,27,4,Connecticut,69,4.64,120,13,San Diego,70,1 OT,1,-9,13 over 4
404,21-Mar-08,2008,2007-08,1,Midwest,22.03,16,5,Clemson,69,14.21,46,12,Villanova,75,,6,-7,12 over 5
405,21-Mar-08,2008,2007-08,1,West,21.46,17,5,Drake,99,14.6,43,12,Western Kentucky,101,1 OT,2,-7,12 over 5
406,21-Mar-08,2008,2007-08,1,Midwest,23.61,11,10,Davidson,82,19.05,25,7,Gonzaga,76,,6,-3,10 over 7
407,21-Mar-08,2008,2007-08,1,East,30.22,3,1,North Carolina,113,-1.32,173,16,Mount St. Mary's,74,,39,15,
408,21-Mar-08,2008,2007-08,1,East,22.17,13,2,Tennessee,72,1.67,150,15,American,57,,15,13,
409,21-Mar-08,2008,2007-08,1,East,25.41,8,3,Louisville,79,3.89,126,14,Boise St.,61,,18,11,
410,21-Mar-08,2008,2007-08,1,East,14.47,44,6,Oklahoma,72,14.32,45,11,Saint Joseph's,64,,8,5,
411,21-Mar-08,2008,2007-08,1,East,19.97,20,7,Butler,81,11.8,65,10,South Alabama,61,,20,3,
412,21-Mar-08,2008,2007-08,1,Midwest,25.56,7,2,Georgetown,66,3.86,127,15,UMBC,47,,19,13,
413,21-Mar-08,2008,2007-08,1,South,31.51,2,1,Memphis,87,-2.31,180,16,UT Arlington,63,,24,15,
414,21-Mar-08,2008,2007-08,1,South,25.09,9,2,Texas,74,-0.3,168,15,Austin Peay,54,,20,13,
415,21-Mar-08,2008,2007-08,1,South,15.38,37,7,Miami FL,78,14.66,42,10,Saint Mary's,64,,14,3,
416,21-Mar-08,2008,2007-08,1,South,16.77,33,8,Mississippi St.,76,15.66,36,9,Oregon,69,,7,1,
417,21-Mar-08,2008,2007-08,1,East,18.43,29,8,Indiana,72,15.19,40,9,Arkansas,86,,14,-1,
418,22-Mar-08,2008,2007-08,2,West,26.4,6,2,Duke,67,21.29,18,7,West Virginia,73,,6,-5,7 over 2
419,22-Mar-08,2008,2007-08,2,East,24.32,10,4,Washington St.,61,19.07,24,5,Notre Dame,41,,20,1,
420,22-Mar-08,2008,2007-08,2,Midwest,35.21,1,1,Kansas,75,13.71,48,8,UNLV,56,,19,7,
421,22-Mar-08,2008,2007-08,2,Midwest,26.68,5,3,Wisconsin,72,18.9,26,11,Kansas St.,55,,17,8,
422,22-Mar-08,2008,2007-08,2,South,22.75,12,3,Stanford,82,22.16,14,6,Marquette,81,1 OT,1,3,
423,22-Mar-08,2008,2007-08,2,West,29.94,4,1,UCLA,53,19.93,21,9,Texas A&M,49,,4,8,
424,22-Mar-08,2008,2007-08,2,West,22.05,15,3,Xavier,85,18.3,30,6,Purdue,78,,7,3,
425,22-Mar-08,2008,2007-08,2,South,21.15,19,5,Michigan St.,65,19.91,22,4,Pittsburgh,54,,11,-1,
426,23-Mar-08,2008,2007-08,2,Midwest,25.56,7,2,Georgetown,70,23.61,11,10,Davidson,74,,4,-8,10 over 2
427,23-Mar-08,2008,2007-08,2,East,30.22,3,1,North Carolina,108,15.19,40,9,Arkansas,77,,31,8,
428,23-Mar-08,2008,2007-08,2,East,22.17,13,2,Tennessee,76,19.97,20,7,Butler,71,1 OT,5,5,
429,23-Mar-08,2008,2007-08,2,East,25.41,8,3,Louisville,78,14.47,44,6,Oklahoma,48,,30,3,
430,23-Mar-08,2008,2007-08,2,Midwest,14.21,46,12,Villanova,84,7.99,93,13,Siena,72,,12,1,
431,23-Mar-08,2008,2007-08,2,South,31.51,2,1,Memphis,77,16.77,33,8,Mississippi St.,74,,3,7,
432,23-Mar-08,2008,2007-08,2,South,25.09,9,2,Texas,75,15.38,37,7,Miami FL,72,,3,5,
433,23-Mar-08,2008,2007-08,2,West,14.6,43,12,Western Kentucky,72,4.64,120,13,San Diego,63,,9,1,
434,27-Mar-08,2008,2007-08,3,East,30.22,3,1,North Carolina,68,24.32,10,4,Washington St.,47,,21,3,
435,27-Mar-08,2008,2007-08,3,West,29.94,4,1,UCLA,88,14.6,43,12,Western Kentucky,78,,10,11,
436,27-Mar-08,2008,2007-08,3,West,22.05,15,3,Xavier,79,21.29,18,7,West Virginia,75,1 OT,4,4,
437,27-Mar-08,2008,2007-08,3,East,25.41,8,3,Louisville,79,22.17,13,2,Tennessee,60,,19,-1,
438,28-Mar-08,2008,2007-08,3,Midwest,26.68,5,3,Wisconsin,56,23.61,11,10,Davidson,73,,17,-7,10 over 3
439,28-Mar-08,2008,2007-08,3,Midwest,35.21,1,1,Kansas,72,14.21,46,12,Villanova,57,,15,11,
440,28-Mar-08,2008,2007-08,3,South,31.51,2,1,Memphis,92,21.15,19,5,Michigan St.,74,,18,4,
441,28-Mar-08,2008,2007-08,3,South,25.09,9,2,Texas,82,22.75,12,3,Stanford,62,,20,1,
442,29-Mar-08,2008,2007-08,4,East,30.22,3,1,North Carolina,83,25.41,8,3,Louisville,73,,10,2,
443,29-Mar-08,2008,2007-08,4,West,29.94,4,1,UCLA,76,22.05,15,3,Xavier,57,,19,2,
444,30-Mar-08,2008,2007-08,4,Midwest,35.21,1,1,Kansas,59,23.61,11,10,Davidson,57,,2,9,
445,30-Mar-08,2008,2007-08,4,South,31.51,2,1,Memphis,85,25.09,9,2,Texas,67,,18,1,
446,5-Apr-08,2008,2007-08,5,Final Four,35.21,1,1,Kansas,84,30.22,3,1,North Carolina,66,,18,0,
447,5-Apr-08,2008,2007-08,5,Final Four,31.51,2,1,Memphis,78,29.94,4,1,UCLA,63,,15,0,
448,7-Apr-08,2008,2007-08,6,Championship,35.21,1,1,Kansas,75,31.51,2,1,Memphis,68,1 OT,7,0,
449,17-Mar-09,2009,2008-09,PI,Midwest,0.76,157,16,Morehead St.,58,-2.97,200,16,Alabama St.,43,,15,0,
450,19-Mar-09,2009,2008-09,1,South,18.72,25,5,Illinois,72,8.1,88,12,Western Kentucky,76,,4,-7,12 over 5
451,19-Mar-09,2009,2008-09,1,South,19.62,23,7,Clemson,59,14.75,47,10,Michigan,62,,3,-3,10 over 7
452,19-Mar-09,2009,2008-09,1,West,17.37,30,7,California,71,13.55,55,10,Maryland,84,,13,-3,10 over 7
453,19-Mar-09,2009,2008-09,1,East,24.31,10,2,Duke,86,-0.98,177,15,Binghamton,62,,24,13,
454,19-Mar-09,2009,2008-09,1,East,23.89,13,3,Villanova,80,4.7,112,14,American,67,,13,11,
455,19-Mar-09,2009,2008-09,1,East,23.93,12,6,UCLA,65,13.62,54,11,VCU,64,,1,5,
456,19-Mar-09,2009,2008-09,1,East,19.65,22,7,Texas,76,15.43,40,10,Minnesota,62,,14,3,
457,19-Mar-09,2009,2008-09,1,South,31.14,1,1,North Carolina,101,-0.86,176,16,Radford,58,,43,15,
458,19-Mar-09,2009,2008-09,1,South,24.59,7,2,Oklahoma,82,0.99,150,15,Morgan St.,54,,28,13,
459,19-Mar-09,2009,2008-09,1,South,24.51,8,4,Gonzaga,77,6.9,95,13,Akron,64,,13,9,
460,19-Mar-09,2009,2008-09,1,South,15.78,38,9,Butler,71,14.86,46,8,LSU,75,,4,1,
461,19-Mar-09,2009,2008-09,1,West,29.25,2,1,Connecticut,103,-4.04,213,16,Chattanooga,47,,56,15,
462,19-Mar-09,2009,2008-09,1,West,28.67,4,2,Memphis,81,5.18,108,15,Cal St. Northridge,70,,11,13,
463,19-Mar-09,2009,2008-09,1,West,22.09,17,4,Washington,71,11.55,69,13,Mississippi St.,58,,13,9,
464,19-Mar-09,2009,2008-09,1,West,21.84,18,5,Purdue,61,9.7,83,12,Northern Iowa,56,,5,7,
465,19-Mar-09,2009,2008-09,1,West,20.1,21,8,BYU,66,15.01,45,9,Texas A&M,79,,13,-1,
466,20-Mar-09,2009,2008-09,1,Midwest,18.88,24,4,Wake Forest,69,11.96,66,13,Cleveland St.,84,,15,-9,13 over 4
467,20-Mar-09,2009,2008-09,1,East,17.62,29,12,Wisconsin,61,15.76,39,5,Florida St.,59,1 OT,2,-7,12 over 5
468,20-Mar-09,2009,2008-09,1,Midwest,17.8,28,5,Utah,71,15.96,37,12,Arizona,84,,13,-7,12 over 5
469,20-Mar-09,2009,2008-09,1,Midwest,24.21,11,6,West Virginia,60,10.23,78,11,Dayton,68,,8,-5,11 over 6
470,20-Mar-09,2009,2008-09,1,Midwest,18.26,27,10,USC,72,11.2,74,7,Boston College,55,,17,-3,10 over 7
471,20-Mar-09,2009,2008-09,1,East,28.96,3,1,Pittsburgh,72,5.67,105,16,East Tennessee St.,62,,10,15,
472,20-Mar-09,2009,2008-09,1,East,20.24,20,4,Xavier,77,4.04,118,13,Portland St.,59,,18,9,
473,20-Mar-09,2009,2008-09,1,East,18.33,26,8,Oklahoma St.,77,16.48,32,9,Tennessee,75,,2,1,
474,20-Mar-09,2009,2008-09,1,Midwest,26.06,5,1,Louisville,74,0.76,157,16,Morehead St.,54,,20,15,
475,20-Mar-09,2009,2008-09,1,Midwest,24.37,9,2,Michigan St.,77,1.49,146,15,Robert Morris,62,,15,13,
476,20-Mar-09,2009,2008-09,1,Midwest,23.83,14,3,Kansas,84,12.29,61,14,North Dakota St.,74,,10,11,
477,20-Mar-09,2009,2008-09,1,South,22.21,16,3,Syracuse,59,6.52,101,14,Stephen F. Austin,44,,15,11,
478,20-Mar-09,2009,2008-09,1,South,23.03,15,6,Arizona St.,66,14.38,50,11,Temple,57,,9,5,
479,20-Mar-09,2009,2008-09,1,West,24.81,6,3,Missouri,78,5.23,107,14,Cornell,59,,19,11,
480,20-Mar-09,2009,2008-09,1,West,21.02,19,6,Marquette,58,15.12,44,11,Utah St.,57,,1,5,
481,20-Mar-09,2009,2008-09,1,Midwest,16.34,34,8,Ohio St.,72,11.93,67,9,Siena,74,2 OT,2,-1,
482,21-Mar-09,2009,2008-09,2,East,24.31,10,2,Duke,74,19.65,22,7,Texas,69,,5,5,
483,21-Mar-09,2009,2008-09,2,East,23.93,12,6,UCLA,69,23.89,13,3,Villanova,89,,20,3,
484,21-Mar-09,2009,2008-09,2,South,31.14,1,1,North Carolina,84,14.86,46,8,LSU,70,,14,7,
485,21-Mar-09,2009,2008-09,2,South,24.59,7,2,Oklahoma,73,14.75,47,10,Michigan,63,,10,8,
486,21-Mar-09,2009,2008-09,2,South,24.51,8,4,Gonzaga,83,8.1,88,12,Western Kentucky,81,,2,8,
487,21-Mar-09,2009,2008-09,2,West,29.25,2,1,Connecticut,92,15.01,45,9,Texas A&M,66,,26,8,
488,21-Mar-09,2009,2008-09,2,West,28.67,4,2,Memphis,89,13.55,55,10,Maryland,70,,19,8,
489,21-Mar-09,2009,2008-09,2,West,22.09,17,4,Washington,74,21.84,18,5,Purdue,76,,2,-1,
490,22-Mar-09,2009,2008-09,2,East,28.96,3,1,Pittsburgh,84,18.33,26,8,Oklahoma St.,76,,8,7,
491,22-Mar-09,2009,2008-09,2,East,20.24,20,4,Xavier,60,17.62,29,12,Wisconsin,49,,11,8,
492,22-Mar-09,2009,2008-09,2,Midwest,26.06,5,1,Louisville,79,11.93,67,9,Siena,72,,7,8,
493,22-Mar-09,2009,2008-09,2,Midwest,24.37,9,2,Michigan St.,74,18.26,27,10,USC,69,,5,8,
494,22-Mar-09,2009,2008-09,2,Midwest,23.83,14,3,Kansas,60,10.23,78,11,Dayton,43,,17,8,
495,22-Mar-09,2009,2008-09,2,Midwest,15.96,37,12,Arizona,71,11.96,66,13,Cleveland St.,57,,14,1,
496,22-Mar-09,2009,2008-09,2,South,23.03,15,6,Arizona St.,67,22.21,16,3,Syracuse,78,,11,3,
497,22-Mar-09,2009,2008-09,2,West,24.81,6,3,Missouri,83,21.02,19,6,Marquette,79,,4,3,
498,26-Mar-09,2009,2008-09,3,East,28.96,3,1,Pittsburgh,60,20.24,20,4,Xavier,55,,5,3,
499,26-Mar-09,2009,2008-09,3,West,29.25,2,1,Connecticut,72,21.84,18,5,Purdue,60,,12,4,
500,26-Mar-09,2009,2008-09,3,East,24.31,10,2,Duke,54,23.89,13,3,Villanova,77,,23,-1,
501,26-Mar-09,2009,2008-09,3,West,28.67,4,2,Memphis,91,24.81,6,3,Missouri,102,,11,-1,
502,27-Mar-09,2009,2008-09,3,Midwest,26.06,5,1,Louisville,103,15.96,37,12,Arizona,64,,39,11,
503,27-Mar-09,2009,2008-09,3,Midwest,24.37,9,2,Michigan St.,67,23.83,14,3,Kansas,62,,5,1,
504,27-Mar-09,2009,2008-09,3,South,31.14,1,1,North Carolina,98,24.51,8,4,Gonzaga,77,,21,3,
505,27-Mar-09,2009,2008-09,3,South,24.59,7,2,Oklahoma,84,22.21,16,3,Syracuse,71,,13,1,
506,28-Mar-09,2009,2008-09,4,East,28.96,3,1,Pittsburgh,76,23.89,13,3,Villanova,78,,2,-2,
507,28-Mar-09,2009,2008-09,4,West,29.25,2,1,Connecticut,82,24.81,6,3,Missouri,75,,7,2,
508,29-Mar-09,2009,2008-09,4,South,31.14,1,1,North Carolina,72,24.59,7,2,Oklahoma,60,,12,1,
509,29-Mar-09,2009,2008-09,4,Midwest,26.06,5,1,Louisville,52,24.37,9,2,Michigan St.,64,,12,-1,
510,4-Apr-09,2009,2008-09,5,Final Four,31.14,1,1,North Carolina,83,23.89,13,3,Villanova,69,,14,2,
511,4-Apr-09,2009,2008-09,5,Final Four,29.25,2,1,Connecticut,73,24.37,9,2,Michigan St.,82,,9,-1,
512,6-Apr-09,2009,2008-09,6,Championship,31.14,1,1,North Carolina,89,24.37,9,2,Michigan St.,72,,17,1,
513,16-Mar-10,2010,2009-10,PI,South,-5.63,225,16,Winthrop,44,-6.44,231,16,Arkansas Pine Bluff,61,,17,0,
514,18-Mar-10,2010,2009-10,1,Midwest,22.64,11,3,Georgetown,83,8.25,94,14,Ohio,97,,14,-11,14 over 3
515,18-Mar-10,2010,2009-10,1,West,17.54,36,4,Vanderbilt,65,15.06,53,13,Murray St.,66,,1,-9,13 over 4
516,18-Mar-10,2010,2009-10,1,East,19.65,24,6,Marquette,78,18.19,32,11,Washington,80,,2,-5,11 over 6
517,18-Mar-10,2010,2009-10,1,South,17.71,35,6,Notre Dame,50,17.51,37,11,Old Dominion,51,,1,-5,11 over 6
518,18-Mar-10,2010,2009-10,1,South,18.59,29,10,Saint Mary's,80,15.01,54,7,Richmond,71,,9,-3,10 over 7
519,18-Mar-10,2010,2009-10,1,East,26.54,4,1,Kentucky,100,2.47,150,16,East Tennessee St.,71,,29,15,
520,18-Mar-10,2010,2009-10,1,East,16.18,43,3,New Mexico,62,8.08,95,14,Montana,57,,5,11,
521,18-Mar-10,2010,2009-10,1,Midwest,31.85,2,1,Kansas,90,-0.97,186,16,Lehigh,74,,16,15,
522,18-Mar-10,2010,2009-10,1,Midwest,18.5,30,6,Tennessee,62,16.58,40,11,San Diego St.,59,,3,5,
523,18-Mar-10,2010,2009-10,1,South,21.24,17,2,Villanova,73,-0.97,185,15,Robert Morris,70,1 OT,3,13,
524,18-Mar-10,2010,2009-10,1,South,24.95,8,3,Baylor,68,7.42,100,14,Sam Houston St.,59,,9,11,
525,18-Mar-10,2010,2009-10,1,West,25.52,6,2,Kansas St.,82,-0.47,175,15,North Texas,62,,20,13,
526,18-Mar-10,2010,2009-10,1,West,22.45,12,5,Butler,77,16.53,42,12,UTEP,59,,18,7,
527,18-Mar-10,2010,2009-10,1,West,23.27,10,7,BYU,99,15.23,50,10,Florida,92,2 OT,7,3,
528,18-Mar-10,2010,2009-10,1,East,20.75,19,8,Texas,80,14.12,58,9,Wake Forest,81,1 OT,1,-1,
529,18-Mar-10,2010,2009-10,1,Midwest,18.87,27,9,Northern Iowa,69,16.56,41,8,UNLV,66,,3,-1,
530,19-Mar-10,2010,2009-10,1,East,20.12,21,5,Temple,65,15.92,46,12,Cornell,78,,13,-7,12 over 5
531,19-Mar-10,2010,2009-10,1,East,19.99,22,10,Missouri,86,19.28,25,7,Clemson,78,,8,-3,10 over 7
532,19-Mar-10,2010,2009-10,1,Midwest,18.22,31,10,Georgia Tech,64,16.72,39,7,Oklahoma St.,59,,5,-3,10 over 7
533,19-Mar-10,2010,2009-10,1,East,25.54,5,2,West Virginia,77,1.58,156,15,Morgan St.,50,,27,13,
534,19-Mar-10,2010,2009-10,1,East,23.56,9,4,Wisconsin,53,10.12,82,13,Wofford,49,,4,9,
535,19-Mar-10,2010,2009-10,1,Midwest,24.99,7,2,Ohio St.,68,2.11,153,15,UC Santa Barbara,51,,17,13,
536,19-Mar-10,2010,2009-10,1,Midwest,22.37,13,4,Maryland,89,8.79,88,13,Houston,77,,12,9,
537,19-Mar-10,2010,2009-10,1,Midwest,20.13,20,5,Michigan St.,70,6.03,112,12,New Mexico St.,67,,3,7,
538,19-Mar-10,2010,2009-10,1,South,33.29,1,1,Duke,73,-6.44,231,16,Arkansas Pine Bluff,44,,29,15,
539,19-Mar-10,2010,2009-10,1,South,22.05,15,4,Purdue,72,13.86,59,13,Siena,64,,8,9,
540,19-Mar-10,2010,2009-10,1,South,21.33,16,5,Texas A&M,69,19.9,23,12,Utah St.,53,,16,7,
541,19-Mar-10,2010,2009-10,1,South,22.15,14,8,California,77,16.91,38,9,Louisville,62,,15,1,
542,19-Mar-10,2010,2009-10,1,West,27.62,3,1,Syracuse,79,3.08,136,16,Vermont,56,,23,15,
543,19-Mar-10,2010,2009-10,1,West,18.66,28,3,Pittsburgh,89,3.19,135,14,Oakland,66,,23,11,
544,19-Mar-10,2010,2009-10,1,West,20.87,18,6,Xavier,65,17.97,34,11,Minnesota,54,,11,5,
545,19-Mar-10,2010,2009-10,1,West,18.02,33,9,Florida St.,60,16.14,44,8,Gonzaga,67,,7,1,
546,20-Mar-10,2010,2009-10,2,East,18.19,32,11,Washington,82,16.18,43,3,New Mexico,64,,18,-8,11 over 3
547,20-Mar-10,2010,2009-10,2,Midwest,31.85,2,1,Kansas,67,18.87,27,9,Northern Iowa,69,,2,-8,9 over 1
548,20-Mar-10,2010,2009-10,2,South,21.24,17,2,Villanova,68,18.59,29,10,Saint Mary's,75,,7,-8,10 over 2
549,20-Mar-10,2010,2009-10,2,East,26.54,4,1,Kentucky,90,14.12,58,9,Wake Forest,60,,30,8,
550,20-Mar-10,2010,2009-10,2,Midwest,18.5,30,6,Tennessee,83,8.25,94,14,Ohio,68,,15,8,
551,20-Mar-10,2010,2009-10,2,South,24.95,8,3,Baylor,76,17.51,37,11,Old Dominion,68,,8,8,
552,20-Mar-10,2010,2009-10,2,West,25.52,6,2,Kansas St.,84,23.27,10,7,BYU,72,,12,5,
553,20-Mar-10,2010,2009-10,2,West,22.45,12,5,Butler,54,15.06,53,13,Murray St.,52,,2,8,
554,21-Mar-10,2010,2009-10,2,East,23.56,9,4,Wisconsin,69,15.92,46,12,Cornell,87,,18,-8,12 over 4
555,21-Mar-10,2010,2009-10,2,West,20.87,18,6,Xavier,71,18.66,28,3,Pittsburgh,68,,3,-3,6 over 3
556,21-Mar-10,2010,2009-10,2,East,25.54,5,2,West Virginia,68,19.99,22,10,Missouri,59,,9,8,
557,21-Mar-10,2010,2009-10,2,Midwest,24.99,7,2,Ohio St.,75,18.22,31,10,Georgia Tech,66,,9,8,
558,21-Mar-10,2010,2009-10,2,South,33.29,1,1,Duke,68,22.15,14,8,California,53,,15,7,
559,21-Mar-10,2010,2009-10,2,South,22.05,15,4,Purdue,63,21.33,16,5,Texas A&M,61,1 OT,2,1,
560,21-Mar-10,2010,2009-10,2,West,27.62,3,1,Syracuse,87,16.14,44,8,Gonzaga,65,,22,7,
561,21-Mar-10,2010,2009-10,2,Midwest,22.37,13,4,Maryland,83,20.13,20,5,Michigan St.,85,,2,-1,
562,25-Mar-10,2010,2009-10,3,West,27.62,3,1,Syracuse,59,22.45,12,5,Butler,63,,4,-4,5 over 1
563,25-Mar-10,2010,2009-10,3,East,26.54,4,1,Kentucky,62,15.92,46,12,Cornell,45,,17,11,
564,25-Mar-10,2010,2009-10,3,East,25.54,5,2,West Virginia,69,18.19,32,11,Washington,56,,13,9,
565,25-Mar-10,2010,2009-10,3,West,25.52,6,2,Kansas St.,101,20.87,18,6,Xavier,96,2 OT,5,4,
566,26-Mar-10,2010,2009-10,3,Midwest,24.99,7,2,Ohio St.,73,18.5,30,6,Tennessee,76,,3,-4,6 over 2
567,26-Mar-10,2010,2009-10,3,Midwest,20.13,20,5,Michigan St.,59,18.87,27,9,Northern Iowa,52,,7,4,
568,26-Mar-10,2010,2009-10,3,South,33.29,1,1,Duke,70,22.05,15,4,Purdue,57,,13,3,
569,26-Mar-10,2010,2009-10,3,South,24.95,8,3,Baylor,72,18.59,29,10,Saint Mary's,49,,23,7,
570,27-Mar-10,2010,2009-10,4,West,25.52,6,2,Kansas St.,56,22.45,12,5,Butler,63,,7,-3,5 over 2
571,27-Mar-10,2010,2009-10,4,East,26.54,4,1,Kentucky,66,25.54,5,2,West Virginia,73,,7,-1,
572,28-Mar-10,2010,2009-10,4,Midwest,20.13,20,5,Michigan St.,70,18.5,30,6,Tennessee,69,,1,1,
573,28-Mar-10,2010,2009-10,4,South,33.29,1,1,Duke,78,24.95,8,3,Baylor,71,,7,2,
574,3-Apr-10,2010,2009-10,5,Final Four,33.29,1,1,Duke,78,25.54,5,2,West Virginia,57,,21,1,
575,3-Apr-10,2010,2009-10,5,Final Four,22.45,12,5,Butler,52,20.13,20,5,Michigan St.,50,,2,0,
576,5-Apr-10,2010,2009-10,6,Championship,33.29,1,1,Duke,61,22.45,12,5,Butler,59,,2,4,
577,15-Mar-11,2011,2010-11,PI,East,19.28,25,12,Clemson,70,12.73,62,12,UAB,52,,18,0,
578,15-Mar-11,2011,2010-11,PI,Southeast,-11.43,276,16,UNC Asheville,81,-11.43,276,16,UNC Asheville,81,1 OT,4,0,
579,16-Mar-11,2011,2010-11,PI,East,-2.1,198,16,UTSA,70,-12.63,289,16,Alabama St.,61,,9,0,
580,16-Mar-11,2011,2010-11,PI,Southwest,14.39,56,11,VCU,59,10.63,77,11,USC,46,,13,0,
581,17-Mar-11,2011,2010-11,1,Southwest,16.91,38,4,Louisville,61,7,102,13,Morehead St.,62,,1,-9,13 over 4
582,17-Mar-11,2011,2010-11,1,Southwest,17.54,36,5,Vanderbilt,66,15.01,54,12,Richmond,69,,3,-7,12 over 5
583,17-Mar-11,2011,2010-11,1,Southeast,16.14,44,11,Gonzaga,86,11.97,67,6,St. John's,71,,15,-5,11 over 6
584,17-Mar-11,2011,2010-11,1,East,26.54,4,4,Kentucky,59,5.29,120,13,Princeton,57,,2,9,
585,17-Mar-11,2011,2010-11,1,East,25.54,5,5,West Virginia,84,19.28,25,12,Clemson,76,,8,7,
586,17-Mar-11,2011,2010-11,1,Southeast,18.66,28,1,Pittsburgh,74,-11.43,276,16,UNC Asheville,51,,23,15,
587,17-Mar-11,2011,2010-11,1,Southeast,15.23,50,2,Florida,79,2.11,153,15,UC Santa Barbara,51,,28,13,
588,17-Mar-11,2011,2010-11,1,Southeast,23.27,10,3,BYU,74,10.12,82,14,Wofford,66,,8,11,
589,17-Mar-11,2011,2010-11,1,Southeast,23.56,9,4,Wisconsin,72,3.67,132,13,Belmont,58,,14,9,
590,17-Mar-11,2011,2010-11,1,Southeast,25.52,6,5,Kansas St.,73,19.9,23,12,Utah St.,68,,5,7,
591,17-Mar-11,2011,2010-11,1,Southeast,20.13,20,10,Michigan St.,76,5.48,117,7,UCLA,78,,2,3,
592,17-Mar-11,2011,2010-11,1,Southeast,22.45,12,8,Butler,60,17.51,37,9,Old Dominion,58,,2,1,
593,17-Mar-11,2011,2010-11,1,West,16.58,40,2,San Diego St.,68,4.82,125,15,Northern Colorado,50,,18,13,
594,17-Mar-11,2011,2010-11,1,West,15.19,51,3,Connecticut,81,-7.96,246,14,Bucknell,52,,29,11,
595,17-Mar-11,2011,2010-11,1,West,19.99,22,11,Missouri,63,11.92,68,6,Cincinnati,78,,15,5,
596,17-Mar-11,2011,2010-11,1,West,20.12,21,7,Temple,66,7.04,101,10,Penn St.,64,,2,3,
597,18-Mar-11,2011,2010-11,1,East,20.87,18,6,Xavier,55,19.65,24,11,Marquette,66,,11,-5,11 over 6
598,18-Mar-11,2011,2010-11,1,Southwest,22.64,11,6,Georgetown,56,14.39,56,11,VCU,74,,18,-5,11 over 6
599,18-Mar-11,2011,2010-11,1,West,15.24,49,12,Memphis,75,8.83,87,5,Arizona,77,,2,7,
600,18-Mar-11,2011,2010-11,1,Southwest,21.33,16,7,Texas A&M,50,18.02,33,10,Florida St.,57,,7,-3,10 over 7
601,18-Mar-11,2011,2010-11,1,East,24.99,7,1,Ohio St.,75,-2.1,198,16,UTSA,46,,29,15,
602,18-Mar-11,2011,2010-11,1,East,13.39,61,2,North Carolina,102,-10.97,270,15,LIU Brooklyn,87,,15,13,
603,18-Mar-11,2011,2010-11,1,East,27.62,3,3,Syracuse,77,3.02,138,14,Indiana St.,60,,17,11,
604,18-Mar-11,2011,2010-11,1,East,18.19,32,7,Washington,68,8.68,91,10,Georgia,65,,3,3,
605,18-Mar-11,2011,2010-11,1,East,21.24,17,9,Villanova,57,0.91,162,8,George Mason,61,,4,1,
606,18-Mar-11,2011,2010-11,1,Southwest,31.85,2,1,Kansas,72,3.51,133,16,Boston University,53,,19,15,
607,18-Mar-11,2011,2010-11,1,Southwest,17.71,35,2,Notre Dame,69,5.2,121,15,Akron,56,,13,13,
608,18-Mar-11,2011,2010-11,1,Southwest,22.05,15,3,Purdue,65,-0.49,176,14,Saint Peter's,43,,22,11,
609,18-Mar-11,2011,2010-11,1,West,33.29,1,1,Duke,87,-6.21,228,16,Hampton,45,,42,15,
610,18-Mar-11,2011,2010-11,1,West,20.75,19,4,Texas,85,3.19,135,13,Oakland,81,,4,9,
611,18-Mar-11,2011,2010-11,1,West,18.5,30,9,Tennessee,45,11.48,70,8,Michigan,75,,30,1,
612,18-Mar-11,2011,2010-11,1,Southwest,16.56,41,8,UNLV,62,14.38,57,9,Illinois,73,,11,-1,
613,19-Mar-11,2011,2010-11,2,Southeast,22.45,12,8,Butler,71,18.66,28,1,Pittsburgh,70,,1,-7,8 over 1
614,19-Mar-11,2011,2010-11,2,East,26.54,4,4,Kentucky,71,25.54,5,5,West Virginia,63,,8,1,
615,19-Mar-11,2011,2010-11,2,Southeast,15.23,50,2,Florida,73,5.48,117,7,UCLA,65,,8,5,
616,19-Mar-11,2011,2010-11,2,Southeast,23.27,10,3,BYU,89,16.14,44,11,Gonzaga,67,,22,8,
617,19-Mar-11,2011,2010-11,2,Southeast,25.52,6,5,Kansas St.,65,23.56,9,4,Wisconsin,70,,5,1,
618,19-Mar-11,2011,2010-11,2,Southwest,15.01,54,12,Richmond,65,7,102,13,Morehead St.,48,,17,1,
619,19-Mar-11,2011,2010-11,2,West,20.12,21,7,Temple,64,16.58,40,2,San Diego St.,71,2 OT,7,5,
620,19-Mar-11,2011,2010-11,2,West,15.19,51,3,Connecticut,69,11.92,68,6,Cincinnati,58,,11,3,
621,20-Mar-11,2011,2010-11,2,East,27.62,3,3,Syracuse,62,19.65,24,11,Marquette,66,,4,-8,11 over 3
622,20-Mar-11,2011,2010-11,2,Southwest,18.02,33,10,Florida St.,71,17.71,35,2,Notre Dame,57,,14,-8,10 over 2
623,20-Mar-11,2011,2010-11,2,Southwest,22.05,15,3,Purdue,76,14.39,56,11,VCU,94,,18,-8,11 over 3
624,20-Mar-11,2011,2010-11,2,West,20.75,19,4,Texas,69,8.83,87,5,Arizona,70,,1,-1,
625,20-Mar-11,2011,2010-11,2,East,24.99,7,1,Ohio St.,98,0.91,162,8,George Mason,66,,32,7,
626,20-Mar-11,2011,2010-11,2,East,18.19,32,7,Washington,83,13.39,61,2,North Carolina,86,,3,5,
627,20-Mar-11,2011,2010-11,2,Southwest,31.85,2,1,Kansas,73,14.38,57,9,Illinois,59,,14,8,
628,20-Mar-11,2011,2010-11,2,West,33.29,1,1,Duke,73,11.48,70,8,Michigan,71,,2,7,
629,24-Mar-11,2011,2010-11,3,Southeast,23.56,9,4,Wisconsin,54,22.45,12,8,Butler,61,,7,-4,8 over 4
630,24-Mar-11,2011,2010-11,3,Southeast,23.27,10,3,BYU,74,15.23,50,2,Florida,83,1 OT,9,1,
631,24-Mar-11,2011,2010-11,3,West,33.29,1,1,Duke,77,8.83,87,5,Arizona,93,,16,-4,5 over 1
632,24-Mar-11,2011,2010-11,3,West,16.58,40,2,San Diego St.,67,15.19,51,3,Connecticut,74,,7,-1,
633,25-Mar-11,2011,2010-11,3,East,26.54,4,4,Kentucky,62,24.99,7,1,Ohio St.,60,,2,-3,4 over 1
634,25-Mar-11,2011,2010-11,3,East,19.65,24,11,Marquette,63,13.39,61,2,North Carolina,81,,18,9,
635,25-Mar-11,2011,2010-11,3,Southwest,31.85,2,1,Kansas,77,15.01,54,12,Richmond,57,,20,11,
636,25-Mar-11,2011,2010-11,3,Southwest,18.02,33,10,Florida St.,71,14.39,56,11,VCU,72,1 OT,1,-1,
637,26-Mar-11,2011,2010-11,4,Southeast,22.45,12,8,Butler,74,15.23,50,2,Florida,71,1 OT,3,-6,8 over 2
638,26-Mar-11,2011,2010-11,4,West,15.19,51,3,Connecticut,65,8.83,87,5,Arizona,63,,2,2,
639,27-Mar-11,2011,2010-11,4,Southwest,31.85,2,1,Kansas,61,14.39,56,11,VCU,71,,10,-10,11 over 1
640,27-Mar-11,2011,2010-11,4,East,26.54,4,4,Kentucky,76,13.39,61,2,North Carolina,69,,7,-2,
641,2-Apr-11,2011,2010-11,5,Final Four,26.54,4,4,Kentucky,55,15.19,51,3,Connecticut,56,,1,1,
642,2-Apr-11,2011,2010-11,5,Final Four,22.45,12,8,Butler,70,14.39,56,11,VCU,62,,8,3,
643,4-Apr-11,2011,2010-11,6,Championship,22.45,12,8,Butler,41,15.19,51,3,Connecticut,53,,12,5,
644,13-Mar-12,2012,2011-12,PI,South,-2.67,193,16,Western Kentucky,59,-6.3,237,16,Mississippi Valley St.,58,,1,0,
645,13-Mar-12,2012,2011-12,PI,West,12.79,50,14,BYU,78,12.26,54,14,Iona,72,,6,0,
646,14-Mar-12,2012,2011-12,PI,Midwest,16.37,29,12,California,54,13.13,48,12,South Florida,65,,11,0,
647,14-Mar-12,2012,2011-12,PI,Midwest,6.33,108,16,Lamar,59,5.17,118,16,Vermont,71,,12,0,
648,15-Mar-12,2012,2011-12,1,South,22.36,11,5,Wichita St.,59,13.45,46,12,VCU,62,,3,-7,12 over 5
649,15-Mar-12,2012,2011-12,1,South,14.97,37,6,UNLV,64,8.89,81,11,Colorado,68,,4,-5,11 over 6
650,15-Mar-12,2012,2011-12,1,East,26.04,5,1,Syracuse,72,5.5,114,16,UNC Asheville,65,,7,15,
651,15-Mar-12,2012,2011-12,1,East,30.07,2,2,Ohio St.,78,3.91,129,15,Loyola MD,59,,19,13,
652,15-Mar-12,2012,2011-12,1,East,24.09,8,4,Wisconsin,73,6.76,104,13,Montana,49,,24,9,
653,15-Mar-12,2012,2011-12,1,East,20.9,16,5,Vanderbilt,79,14.34,41,12,Harvard,70,,9,7,
654,15-Mar-12,2012,2011-12,1,East,18.39,21,7,Gonzaga,77,13.56,44,10,West Virginia,54,,23,3,
655,15-Mar-12,2012,2011-12,1,East,17.52,23,8,Kansas St.,70,10.83,68,9,Southern Miss,64,,6,1,
656,15-Mar-12,2012,2011-12,1,South,32.59,1,1,Kentucky,81,-2.67,193,16,Western Kentucky,66,,15,15,
657,15-Mar-12,2012,2011-12,1,South,21.29,13,3,Baylor,68,11.62,61,14,South Dakota St.,60,,8,11,
658,15-Mar-12,2012,2011-12,1,South,22.55,9,4,Indiana,79,11.22,65,13,New Mexico St.,66,,13,9,
659,15-Mar-12,2012,2011-12,1,South,16.69,26,8,Iowa St.,77,14.53,38,9,Connecticut,64,,13,1,
660,15-Mar-12,2012,2011-12,1,West,20.22,18,3,Marquette,88,12.79,50,14,BYU,68,,20,11,
661,15-Mar-12,2012,2011-12,1,West,20.67,17,4,Louisville,69,10.65,71,13,Davidson,62,,7,9,
662,15-Mar-12,2012,2011-12,1,West,19.45,20,5,New Mexico,75,15.27,36,12,Long Beach St.,68,,7,7,
663,15-Mar-12,2012,2011-12,1,West,15.34,35,6,Murray St.,58,8.17,88,11,Colorado St.,41,,17,5,
664,16-Mar-12,2012,2011-12,1,South,19.7,19,2,Duke,70,9.29,79,15,Lehigh,75,,5,-13,15 over 2
665,16-Mar-12,2012,2011-12,1,West,25.28,7,2,Missouri,84,-1.82,183,15,Norfolk St.,86,,2,-13,15 over 2
666,16-Mar-12,2012,2011-12,1,Midwest,17.52,22,4,Michigan,60,11.88,57,13,Ohio,65,,5,-9,13 over 4
667,16-Mar-12,2012,2011-12,1,Midwest,14.49,39,5,Temple,44,13.13,48,12,South Florida,58,,14,-7,12 over 5
668,16-Mar-12,2012,2011-12,1,Midwest,14.22,43,11,North Carolina St.,79,11.16,66,6,San Diego St.,65,,14,-5,11 over 6
669,16-Mar-12,2012,2011-12,1,Midwest,16.25,30,10,Purdue,72,15.48,34,7,Saint Mary's,69,,3,-3,10 over 7
670,16-Mar-12,2012,2011-12,1,South,14.22,42,7,Notre Dame,63,12.59,53,10,Xavier,67,,4,-3,10 over 7
671,16-Mar-12,2012,2011-12,1,East,17.14,24,3,Florida St.,66,11.78,60,14,St. Bonaventure,63,,3,11,
672,16-Mar-12,2012,2011-12,1,East,16.03,31,6,Cincinnati,65,15.9,32,11,Texas,59,,6,5,
673,16-Mar-12,2012,2011-12,1,Midwest,25.44,6,1,North Carolina,77,5.17,118,16,Vermont,58,,19,15,
674,16-Mar-12,2012,2011-12,1,Midwest,26.91,4,2,Kansas,65,5.48,115,15,Detroit,50,,15,13,
675,16-Mar-12,2012,2011-12,1,Midwest,21.05,15,3,Georgetown,74,16.96,25,14,Belmont,59,,15,11,
676,16-Mar-12,2012,2011-12,1,Midwest,16.69,27,9,Alabama,57,16.47,28,8,Creighton,58,,1,1,
677,16-Mar-12,2012,2011-12,1,West,27.87,3,1,Michigan St.,89,0.75,162,16,LIU Brooklyn,67,,22,15,
678,16-Mar-12,2012,2011-12,1,West,22.47,10,7,Florida,71,15.85,33,10,Virginia,45,,26,3,
679,16-Mar-12,2012,2011-12,1,West,21.9,12,8,Memphis,54,21.2,14,9,Saint Louis,61,,7,-1,
680,17-Mar-12,2012,2011-12,2,East,26.04,5,1,Syracuse,75,17.52,23,8,Kansas St.,59,,16,7,
681,17-Mar-12,2012,2011-12,2,East,30.07,2,2,Ohio St.,73,18.39,21,7,Gonzaga,66,,7,5,
682,17-Mar-12,2012,2011-12,2,East,24.09,8,4,Wisconsin,60,20.9,16,5,Vanderbilt,57,,3,1,
683,17-Mar-12,2012,2011-12,2,South,32.59,1,1,Kentucky,87,16.69,26,8,Iowa St.,71,,16,7,
684,17-Mar-12,2012,2011-12,2,South,21.29,13,3,Baylor,80,8.89,81,11,Colorado,63,,17,8,
685,17-Mar-12,2012,2011-12,2,South,22.55,9,4,Indiana,63,13.45,46,12,VCU,61,,2,8,
686,17-Mar-12,2012,2011-12,2,West,20.22,18,3,Marquette,62,15.34,35,6,Murray St.,53,,9,3,
687,17-Mar-12,2012,2011-12,2,West,20.67,17,4,Louisville,59,19.45,20,5,New Mexico,56,,3,1,
688,18-Mar-12,2012,2011-12,2,Midwest,21.05,15,3,Georgetown,63,14.22,43,11,North Carolina St.,66,,3,-8,11 over 3
689,18-Mar-12,2012,2011-12,2,East,17.14,24,3,Florida St.,56,16.03,31,6,Cincinnati,62,,6,-3,6 over 3
690,18-Mar-12,2012,2011-12,2,Midwest,25.44,6,1,North Carolina,87,16.47,28,8,Creighton,73,,14,7,
691,18-Mar-12,2012,2011-12,2,Midwest,26.91,4,2,Kansas,63,16.25,30,10,Purdue,60,,3,8,
692,18-Mar-12,2012,2011-12,2,South,12.59,53,10,Xavier,70,9.29,79,15,Lehigh,58,,12,5,
693,18-Mar-12,2012,2011-12,2,West,27.87,3,1,Michigan St.,65,21.2,14,9,Saint Louis,61,,4,8,
694,18-Mar-12,2012,2011-12,2,West,22.47,10,7,Florida,84,-1.82,183,15,Norfolk St.,50,,34,8,
695,18-Mar-12,2012,2011-12,2,Midwest,13.13,48,12,South Florida,56,11.88,57,13,Ohio,62,,6,-1,
696,22-Mar-12,2012,2011-12,3,West,22.47,10,7,Florida,68,20.22,18,3,Marquette,58,,10,-4,7 over 3
697,22-Mar-12,2012,2011-12,3,West,27.87,3,1,Michigan St.,44,20.67,17,4,Louisville,57,,13,-3,4 over 1
698,22-Mar-12,2012,2011-12,3,East,26.04,5,1,Syracuse,64,24.09,8,4,Wisconsin,63,,1,3,
699,22-Mar-12,2012,2011-12,3,East,30.07,2,2,Ohio St.,81,16.03,31,6,Cincinnati,66,,15,4,
700,23-Mar-12,2012,2011-12,3,Midwest,25.44,6,1,North Carolina,73,11.88,57,13,Ohio,65,1 OT,8,12,
701,23-Mar-12,2012,2011-12,3,Midwest,26.91,4,2,Kansas,60,14.22,43,11,North Carolina St.,57,,3,9,
702,23-Mar-12,2012,2011-12,3,South,32.59,1,1,Kentucky,102,22.55,9,4,Indiana,90,,12,3,
703,23-Mar-12,2012,2011-12,3,South,21.29,13,3,Baylor,75,12.59,53,10,Xavier,70,,5,7,
704,24-Mar-12,2012,2011-12,4,West,22.47,10,7,Florida,68,20.67,17,4,Louisville,72,,4,3,
705,24-Mar-12,2012,2011-12,4,East,30.07,2,2,Ohio St.,77,26.04,5,1,Syracuse,70,,7,-1,
706,25-Mar-12,2012,2011-12,4,South,32.59,1,1,Kentucky,82,21.29,13,3,Baylor,70,,12,2,
707,25-Mar-12,2012,2011-12,4,Midwest,26.91,4,2,Kansas,80,25.44,6,1,North Carolina,67,,13,-1,
708,31-Mar-12,2012,2011-12,5,Final Four,32.59,1,1,Kentucky,69,20.67,17,4,Louisville,61,,8,3,
709,31-Mar-12,2012,2011-12,5,Final Four,30.07,2,2,Ohio St.,62,26.91,4,2,Kansas,64,,2,0,
710,2-Apr-12,2012,2011-12,6,Championship,32.59,1,1,Kentucky,67,26.91,4,2,Kansas,59,,8,1,
711,19-Mar-13,2013,2012-13,PI,Midwest,19.33,21,11,Saint Mary's,67,14.77,44,11,Middle Tennessee,54,,13,0,
712,19-Mar-13,2013,2012-13,PI,Midwest,-5.3,227,16,North Carolina A&T,73,-9.38,266,16,Liberty,72,,1,0,
713,20-Mar-13,2013,2012-13,PI,East,-0.92,182,16,James Madison,68,-2.13,192,16,LIU Brooklyn,55,,13,0,
714,20-Mar-13,2013,2012-13,PI,West,13.89,50,13,La Salle,80,13.54,54,13,Boise St.,71,,9,0,
715,21-Mar-13,2013,2012-13,1,West,19.02,23,3,New Mexico,62,7.07,93,14,Harvard,68,,6,-11,14 over 3
716,21-Mar-13,2013,2012-13,1,East,16.07,38,5,UNLV,61,13.11,56,12,California,64,,3,-7,12 over 5
717,21-Mar-13,2013,2012-13,1,Midwest,18.69,24,5,Oklahoma St.,55,16.78,35,12,Oregon,68,,13,-7,12 over 5
718,21-Mar-13,2013,2012-13,1,East,18.32,26,3,Marquette,59,11.36,66,14,Davidson,58,,1,11,
719,21-Mar-13,2013,2012-13,1,East,24.83,9,4,Syracuse,81,2.14,145,13,Montana,34,,47,9,
720,21-Mar-13,2013,2012-13,1,East,15.41,42,6,Butler,68,12.72,58,11,Bucknell,56,,12,5,
721,21-Mar-13,2013,2012-13,1,Midwest,32.92,1,1,Louisville,79,-5.3,227,16,North Carolina A&T,48,,31,15,
722,21-Mar-13,2013,2012-13,1,Midwest,24.17,10,3,Michigan St.,65,11.42,65,14,Valparaiso,54,,11,11,
723,21-Mar-13,2013,2012-13,1,Midwest,20.01,19,4,Saint Louis,64,7.68,88,13,New Mexico St.,44,,20,9,
724,21-Mar-13,2013,2012-13,1,Midwest,19.33,21,11,Saint Mary's,52,16.33,37,6,Memphis,54,,2,5,
725,21-Mar-13,2013,2012-13,1,Midwest,19.12,22,8,Colorado St.,84,18.53,25,9,Missouri,72,,12,1,
726,21-Mar-13,2013,2012-13,1,South,27.86,4,4,Michigan,71,6.79,96,13,South Dakota St.,56,,15,9,
727,21-Mar-13,2013,2012-13,1,South,20.28,18,5,VCU,88,11.52,62,12,Akron,42,,46,7,
728,21-Mar-13,2013,2012-13,1,West,27.81,5,1,Gonzaga,64,0.5,162,16,Southern,58,,6,15,
729,21-Mar-13,2013,2012-13,1,West,21.88,14,6,Arizona,81,14.92,43,11,Belmont,64,,17,5,
730,21-Mar-13,2013,2012-13,1,West,24.08,11,8,Pittsburgh,55,20.31,17,9,Wichita St.,73,,18,-1,
731,22-Mar-13,2013,2012-13,1,South,21.24,16,2,Georgetown,68,6.27,105,15,Florida Gulf Coast,78,,10,-13,15 over 2
732,22-Mar-13,2013,2012-13,1,West,18.16,27,4,Kansas St.,61,13.89,50,13,La Salle,63,,2,-9,13 over 4
733,22-Mar-13,2013,2012-13,1,West,22.57,12,5,Wisconsin,46,16.95,34,12,Mississippi,57,,11,-7,12 over 5
734,22-Mar-13,2013,2012-13,1,South,19.85,20,11,Minnesota,83,14.53,46,6,UCLA,63,,20,-5,11 over 6
735,22-Mar-13,2013,2012-13,1,West,17.63,30,10,Iowa St.,76,16.65,36,7,Notre Dame,58,,18,-3,10 over 7
736,22-Mar-13,2013,2012-13,1,East,29.31,3,1,Indiana,83,-0.92,182,16,James Madison,62,,21,15,
737,22-Mar-13,2013,2012-13,1,East,22.37,13,2,Miami FL,78,3.96,128,15,Pacific,49,,29,13,
738,22-Mar-13,2013,2012-13,1,East,15.82,39,7,Illinois,57,14.62,45,10,Colorado,49,,8,3,
739,22-Mar-13,2013,2012-13,1,Midwest,26.98,6,2,Duke,73,1.36,150,15,Albany,61,,12,13,
740,22-Mar-13,2013,2012-13,1,Midwest,21.75,15,7,Creighton,67,15.57,40,10,Cincinnati,63,,4,3,
741,22-Mar-13,2013,2012-13,1,South,25.23,8,1,Kansas,64,-0.41,173,16,Western Kentucky,57,,7,15,
742,22-Mar-13,2013,2012-13,1,South,31.18,2,3,Florida,79,2.82,138,14,Northwestern St.,47,,32,11,
743,22-Mar-13,2013,2012-13,1,South,17.43,31,7,San Diego St.,70,13.8,51,10,Oklahoma,55,,15,3,
744,22-Mar-13,2013,2012-13,1,South,17.14,32,8,North Carolina,78,13.57,53,9,Villanova,71,,7,1,
745,22-Mar-13,2013,2012-13,1,West,25.42,7,2,Ohio St.,95,7.45,89,15,Iona,70,,25,13,
746,22-Mar-13,2013,2012-13,1,East,16.99,33,8,North Carolina St.,72,12.67,59,9,Temple,76,,4,-1,
747,23-Mar-13,2013,2012-13,2,Midwest,20.01,19,4,Saint Louis,57,16.78,35,12,Oregon,74,,17,-8,12 over 4
748,23-Mar-13,2013,2012-13,2,West,27.81,5,1,Gonzaga,70,20.31,17,9,Wichita St.,76,,6,-8,9 over 1
749,23-Mar-13,2013,2012-13,2,East,18.32,26,3,Marquette,74,15.41,42,6,Butler,72,,2,3,
750,23-Mar-13,2013,2012-13,2,East,24.83,9,4,Syracuse,66,13.11,56,12,California,60,,6,8,
751,23-Mar-13,2013,2012-13,2,Midwest,32.92,1,1,Louisville,82,19.12,22,8,Colorado St.,56,,26,7,
752,23-Mar-13,2013,2012-13,2,Midwest,24.17,10,3,Michigan St.,70,16.33,37,6,Memphis,48,,22,3,
753,23-Mar-13,2013,2012-13,2,South,27.86,4,4,Michigan,78,20.28,18,5,VCU,53,,25,1,
754,23-Mar-13,2013,2012-13,2,West,21.88,14,6,Arizona,74,7.07,93,14,Harvard,51,,23,8,
755,24-Mar-13,2013,2012-13,2,South,17.43,31,7,San Diego St.,71,6.27,105,15,Florida Gulf Coast,81,,10,-8,15 over 7
756,24-Mar-13,2013,2012-13,2,East,29.31,3,1,Indiana,58,12.67,59,9,Temple,52,,6,8,
757,24-Mar-13,2013,2012-13,2,East,22.37,13,2,Miami FL,63,15.82,39,7,Illinois,59,,4,5,
758,24-Mar-13,2013,2012-13,2,Midwest,26.98,6,2,Duke,66,21.75,15,7,Creighton,50,,16,5,
759,24-Mar-13,2013,2012-13,2,South,25.23,8,1,Kansas,70,17.14,32,8,North Carolina,58,,12,7,
760,24-Mar-13,2013,2012-13,2,South,31.18,2,3,Florida,78,19.85,20,11,Minnesota,64,,14,8,
761,24-Mar-13,2013,2012-13,2,West,25.42,7,2,Ohio St.,78,17.63,30,10,Iowa St.,75,,3,8,
762,24-Mar-13,2013,2012-13,2,West,16.95,34,12,Mississippi,74,13.89,50,13,La Salle,76,,2,-1,
763,28-Mar-13,2013,2012-13,3,East,29.31,3,1,Indiana,50,24.83,9,4,Syracuse,61,,11,-3,4 over 1
764,28-Mar-13,2013,2012-13,3,West,25.42,7,2,Ohio St.,73,21.88,14,6,Arizona,70,,3,4,
765,28-Mar-13,2013,2012-13,3,West,20.31,17,9,Wichita St.,72,13.89,50,13,La Salle,58,,14,4,
766,28-Mar-13,2013,2012-13,3,East,22.37,13,2,Miami FL,61,18.32,26,3,Marquette,71,,10,-1,
767,29-Mar-13,2013,2012-13,3,South,27.86,4,4,Michigan,87,25.23,8,1,Kansas,85,1 OT,2,-3,4 over 1
768,29-Mar-13,2013,2012-13,3,Midwest,32.92,1,1,Louisville,77,16.78,35,12,Oregon,69,,8,11,
769,29-Mar-13,2013,2012-13,3,Midwest,26.98,6,2,Duke,71,24.17,10,3,Michigan St.,61,,10,1,
770,29-Mar-13,2013,2012-13,3,South,31.18,2,3,Florida,62,6.27,105,15,Florida Gulf Coast,50,,12,12,
771,30-Mar-13,2013,2012-13,4,West,25.42,7,2,Ohio St.,66,20.31,17,9,Wichita St.,70,,4,-7,9 over 2
772,30-Mar-13,2013,2012-13,4,East,24.83,9,4,Syracuse,55,18.32,26,3,Marquette,39,,16,-1,
773,31-Mar-13,2013,2012-13,4,Midwest,32.92,1,1,Louisville,85,26.98,6,2,Duke,63,,22,1,
774,31-Mar-13,2013,2012-13,4,South,31.18,2,3,Florida,59,27.86,4,4,Michigan,79,,20,-1,
775,6-Apr-13,2013,2012-13,5,Final Four,32.92,1,1,Louisville,72,20.31,17,9,Wichita St.,68,,4,8,
776,6-Apr-13,2013,2012-13,5,Final Four,27.86,4,4,Michigan,61,24.83,9,4,Syracuse,56,,5,0,
777,8-Apr-13,2013,2012-13,6,Championship,32.92,1,1,Louisville,82,27.86,4,4,Michigan,76,,6,3,
778,18-Mar-14,2014,2013-14,PI,Midwest,13.11,52,12,Xavier,59,11.6,62,12,North Carolina St.,74,,15,0,
779,18-Mar-14,2014,2013-14,PI,South,-1.04,181,16,Albany,71,-3.96,209,16,Mount St. Mary's,64,,7,0,
780,19-Mar-14,2014,2013-14,PI,Midwest,23.69,10,11,Tennessee,78,20.44,22,11,Iowa,65,1 OT,13,0,
781,19-Mar-14,2014,2013-14,PI,Midwest,-0.82,176,16,Cal Poly,81,-7.49,259,16,Texas Southern,69,,12,0,
782,20-Mar-14,2014,2013-14,1,East,19.24,27,5,Cincinnati,57,17.58,32,12,Harvard,61,,4,-7,12 over 5
783,20-Mar-14,2014,2013-14,1,West,17.9,30,5,Oklahoma,75,11.76,61,12,North Dakota St.,80,1 OT,5,-7,12 over 5
784,20-Mar-14,2014,2013-14,1,South,21.3,19,6,Ohio St.,59,14.25,42,11,Dayton,60,,1,-5,11 over 6
785,20-Mar-14,2014,2013-14,1,East,23.68,11,2,Villanova,73,0.08,168,15,Milwaukee,53,,20,13,
786,20-Mar-14,2014,2013-14,1,East,23.92,9,4,Michigan St.,93,5.83,106,13,Delaware,78,,15,9,
787,20-Mar-14,2014,2013-14,1,East,22.13,15,7,Connecticut,89,12.93,55,10,Saint Joseph's,81,1 OT,8,3,
788,20-Mar-14,2014,2013-14,1,Midwest,23.44,12,2,Michigan,57,-1.94,192,15,Wofford,40,,17,13,
789,20-Mar-14,2014,2013-14,1,Midwest,30.41,1,4,Louisville,71,10.21,74,13,Manhattan,64,,7,9,
790,20-Mar-14,2014,2013-14,1,Midwest,15.72,35,5,Saint Louis,83,11.6,62,12,North Carolina St.,80,1 OT,3,7,
791,20-Mar-14,2014,2013-14,1,Midwest,14.82,39,10,Arizona St.,85,14.52,41,7,Texas,87,,2,3,
792,20-Mar-14,2014,2013-14,1,South,28.57,3,1,Florida,67,-1.04,181,16,Albany,55,,12,15,
793,20-Mar-14,2014,2013-14,1,South,21.62,18,3,Syracuse,77,3.36,131,14,Western Michigan,53,,24,11,
794,20-Mar-14,2014,2013-14,1,West,25.89,5,2,Wisconsin,75,4.57,120,15,American,35,,40,13,
795,20-Mar-14,2014,2013-14,1,West,20.38,23,4,San Diego St.,73,10.54,72,13,New Mexico St.,69,1 OT,4,9,
796,20-Mar-14,2014,2013-14,1,West,19.02,28,7,Oregon,87,13.77,49,10,BYU,68,,19,3,
797,20-Mar-14,2014,2013-14,1,South,21.89,16,9,Pittsburgh,77,11.2,67,8,Colorado,48,,29,-1,
798,21-Mar-14,2014,2013-14,1,Midwest,24.25,8,3,Duke,71,8.34,87,14,Mercer,78,,7,-11,14 over 3
799,21-Mar-14,2014,2013-14,1,South,19.8,25,5,VCU,75,10.83,70,12,Stephen F. Austin,77,1 OT,2,-7,12 over 5
800,21-Mar-14,2014,2013-14,1,Midwest,23.69,10,11,Tennessee,86,13.46,50,6,Massachusetts,67,,19,-5,11 over 6
801,21-Mar-14,2014,2013-14,1,South,17.15,33,7,New Mexico,53,16.06,34,10,Stanford,58,,5,-3,10 over 7
802,21-Mar-14,2014,2013-14,1,East,26.46,4,1,Virginia,70,-4.98,221,16,Coastal Carolina,59,,11,15,
803,21-Mar-14,2014,2013-14,1,East,21.07,20,3,Iowa St.,93,7.98,92,14,North Carolina Central,75,,18,11,
804,21-Mar-14,2014,2013-14,1,East,18.44,29,6,North Carolina,79,13.81,48,11,Providence,77,,2,5,
805,21-Mar-14,2014,2013-14,1,East,15.22,36,8,Memphis,71,13.82,47,9,George Washington,66,,5,1,
806,21-Mar-14,2014,2013-14,1,Midwest,25.36,6,1,Wichita St.,64,-0.82,176,16,Cal Poly,37,,27,15,
807,21-Mar-14,2014,2013-14,1,Midwest,22.55,13,8,Kentucky,56,14.1,45,9,Kansas St.,49,,7,1,
808,21-Mar-14,2014,2013-14,1,South,24.6,7,2,Kansas,80,3.96,125,15,Eastern Kentucky,69,,11,13,
809,21-Mar-14,2014,2013-14,1,South,22.53,14,4,UCLA,76,8.93,82,13,Tulsa,59,,17,9,
810,21-Mar-14,2014,2013-14,1,West,30.11,2,1,Arizona,68,-0.62,172,16,Weber St.,59,,9,15,
811,21-Mar-14,2014,2013-14,1,West,21.72,17,3,Creighton,76,-6.43,245,14,Lafayette,66,,10,11,
812,21-Mar-14,2014,2013-14,1,West,19.39,26,6,Baylor,74,12.64,56,11,Nebraska,60,,14,5,
813,21-Mar-14,2014,2013-14,1,West,20.98,21,9,Oklahoma St.,77,20.14,24,8,Gonzaga,85,,8,1,
814,22-Mar-14,2014,2013-14,2,South,21.62,18,3,Syracuse,53,14.25,42,11,Dayton,55,,2,-8,11 over 3
815,22-Mar-14,2014,2013-14,2,East,23.68,11,2,Villanova,65,22.13,15,7,Connecticut,77,,12,-5,7 over 2
816,22-Mar-14,2014,2013-14,2,East,23.92,9,4,Michigan St.,80,17.58,32,12,Harvard,73,,7,8,
817,22-Mar-14,2014,2013-14,2,Midwest,23.44,12,2,Michigan,79,14.52,41,7,Texas,65,,14,5,
818,22-Mar-14,2014,2013-14,2,Midwest,30.41,1,4,Louisville,66,15.72,35,5,Saint Louis,51,,15,1,
819,22-Mar-14,2014,2013-14,2,South,28.57,3,1,Florida,61,21.89,16,9,Pittsburgh,45,,16,8,
820,22-Mar-14,2014,2013-14,2,West,25.89,5,2,Wisconsin,85,19.02,28,7,Oregon,77,,8,5,
821,22-Mar-14,2014,2013-14,2,West,20.38,23,4,San Diego St.,63,11.76,61,12,North Dakota St.,44,,19,8,
822,23-Mar-14,2014,2013-14,2,South,24.6,7,2,Kansas,57,16.06,34,10,Stanford,60,,3,-8,10 over 2
823,23-Mar-14,2014,2013-14,2,Midwest,25.36,6,1,Wichita St.,76,22.55,13,8,Kentucky,78,,2,-7,8 over 1
824,23-Mar-14,2014,2013-14,2,West,21.72,17,3,Creighton,55,19.39,26,6,Baylor,85,,30,-3,6 over 3
825,23-Mar-14,2014,2013-14,2,East,26.46,4,1,Virginia,78,15.22,36,8,Memphis,60,,18,7,
826,23-Mar-14,2014,2013-14,2,East,21.07,20,3,Iowa St.,85,18.44,29,6,North Carolina,83,,2,3,
827,23-Mar-14,2014,2013-14,2,Midwest,23.69,10,11,Tennessee,83,8.34,87,14,Mercer,63,,20,3,
828,23-Mar-14,2014,2013-14,2,South,22.53,14,4,UCLA,77,10.83,70,12,Stephen F. Austin,60,,17,8,
829,23-Mar-14,2014,2013-14,2,West,30.11,2,1,Arizona,84,20.14,24,8,Gonzaga,61,,23,7,
830,27-Mar-14,2014,2013-14,3,South,28.57,3,1,Florida,79,22.53,14,4,UCLA,68,,11,3,
831,27-Mar-14,2014,2013-14,3,West,30.11,2,1,Arizona,70,20.38,23,4,San Diego St.,64,,6,3,
832,27-Mar-14,2014,2013-14,3,West,25.89,5,2,Wisconsin,69,19.39,26,6,Baylor,52,,17,4,
833,27-Mar-14,2014,2013-14,3,South,16.06,34,10,Stanford,72,14.25,42,11,Dayton,82,,10,-1,
834,28-Mar-14,2014,2013-14,3,East,22.13,15,7,Connecticut,81,21.07,20,3,Iowa St.,76,,5,-4,7 over 3
835,28-Mar-14,2014,2013-14,3,Midwest,30.41,1,4,Louisville,69,22.55,13,8,Kentucky,74,,5,-4,8 over 4
836,28-Mar-14,2014,2013-14,3,East,26.46,4,1,Virginia,59,23.92,9,4,Michigan St.,61,,2,-3,4 over 1
837,28-Mar-14,2014,2013-14,3,Midwest,23.69,10,11,Tennessee,71,23.44,12,2,Michigan,73,,2,9,
838,29-Mar-14,2014,2013-14,4,South,28.57,3,1,Florida,62,14.25,42,11,Dayton,52,,10,10,
839,29-Mar-14,2014,2013-14,4,West,30.11,2,1,Arizona,63,25.89,5,2,Wisconsin,64,1 OT,1,-1,
840,30-Mar-14,2014,2013-14,4,Midwest,23.44,12,2,Michigan,72,22.55,13,8,Kentucky,75,,3,-6,8 over 2
841,30-Mar-14,2014,2013-14,4,East,23.92,9,4,Michigan St.,54,22.13,15,7,Connecticut,60,,6,-3,7 over 4
842,5-Apr-14,2014,2013-14,5,Final Four,28.57,3,1,Florida,53,22.13,15,7,Connecticut,63,,10,-6,7 over 1
843,5-Apr-14,2014,2013-14,5,Final Four,25.89,5,2,Wisconsin,73,22.55,13,8,Kentucky,74,,1,-6,8 over 2
844,7-Apr-14,2014,2013-14,6,Championship,22.55,13,8,Kentucky,54,22.13,15,7,Connecticut,60,,6,1,
845,17-Mar-15,2015,2014-15,PI,Midwest,0.31,162,16,Manhattan,64,-7.4,251,16,Hampton,74,,10,0,
846,17-Mar-15,2015,2014-15,PI,West,16.69,28,11,BYU,90,13.88,46,11,Mississippi,94,,4,0,
847,18-Mar-15,2015,2014-15,PI,East,14.24,42,11,Dayton,56,13.85,47,11,Boise St.,55,,1,0,
848,18-Mar-15,2015,2014-15,PI,South,2.26,143,16,North Florida,77,-1.39,184,16,Robert Morris,81,,4,0,
849,19-Mar-15,2015,2014-15,1,South,21.49,16,3,Iowa St.,59,3.06,135,14,UAB,60,,1,-11,14 over 3
850,19-Mar-15,2015,2014-15,1,West,22.14,14,3,Baylor,56,10.32,68,14,Georgia St.,57,,1,-11,14 over 3
851,19-Mar-15,2015,2014-15,1,South,17.51,26,6,SMU,59,14.65,40,11,UCLA,60,,1,-5,11 over 6
852,19-Mar-15,2015,2014-15,1,West,20.75,19,10,Ohio St.,75,16.27,30,7,VCU,72,1 OT,3,-3,10 over 7
853,19-Mar-15,2015,2014-15,1,East,30.65,5,1,Villanova,93,-2.14,193,16,Lafayette,52,,41,15,
854,19-Mar-15,2015,2014-15,1,East,15.93,32,8,North Carolina St.,66,13.76,49,9,LSU,65,,1,1,
855,19-Mar-15,2015,2014-15,1,Midwest,36.91,1,1,Kentucky,79,-7.4,251,16,Hampton,56,,23,15,
856,19-Mar-15,2015,2014-15,1,Midwest,24.96,9,3,Notre Dame,69,5.12,117,14,Northeastern,65,,4,11,
857,19-Mar-15,2015,2014-15,1,Midwest,20.09,20,6,Butler,56,18.94,24,11,Texas,48,,8,5,
858,19-Mar-15,2015,2014-15,1,Midwest,14.15,43,8,Cincinnati,66,13.96,44,9,Purdue,65,1 OT,1,1,
859,19-Mar-15,2015,2014-15,1,South,19.13,22,4,Georgetown,84,3.25,133,13,Eastern Washington,74,,10,9,
860,19-Mar-15,2015,2014-15,1,South,27.24,8,5,Utah,57,13.64,51,12,Stephen F. Austin,50,,7,7,
861,19-Mar-15,2015,2014-15,1,West,32.36,4,2,Arizona,93,-3.84,213,15,Texas Southern,72,,21,13,
862,19-Mar-15,2015,2014-15,1,West,23.85,10,4,North Carolina,67,9.23,75,13,Harvard,65,,2,9,
863,19-Mar-15,2015,2014-15,1,West,16.44,29,5,Arkansas,56,6.72,96,12,Wofford,53,,3,7,
864,19-Mar-15,2015,2014-15,1,West,19.49,21,6,Xavier,76,13.88,46,11,Mississippi,57,,19,5,
865,20-Mar-15,2015,2014-15,1,East,16.72,27,6,Providence,53,14.24,42,11,Dayton,66,,13,-5,11 over 6
866,20-Mar-15,2015,2014-15,1,East,30.06,6,2,Virginia,79,2.27,142,15,Belmont,67,,12,13,
867,20-Mar-15,2015,2014-15,1,East,22.8,11,3,Oklahoma,69,3.29,131,14,Albany,60,,9,11,
868,20-Mar-15,2015,2014-15,1,East,21.21,17,4,Louisville,57,7.09,91,13,UC Irvine,55,,2,9,
869,20-Mar-15,2015,2014-15,1,East,20.98,18,5,Northern Iowa,71,5.67,109,12,Wyoming,54,,17,7,
870,20-Mar-15,2015,2014-15,1,East,21.72,15,7,Michigan St.,70,15.09,35,10,Georgia,63,,7,3,
871,20-Mar-15,2015,2014-15,1,Midwest,22.72,12,2,Kansas,75,6.63,98,15,New Mexico St.,56,,19,13,
872,20-Mar-15,2015,2014-15,1,Midwest,15.68,33,4,Maryland,65,11.13,64,13,Valparaiso,62,,3,9,
873,20-Mar-15,2015,2014-15,1,Midwest,17.64,25,5,West Virginia,68,11.87,58,12,Buffalo,62,,6,7,
874,20-Mar-15,2015,2014-15,1,Midwest,22.21,13,7,Wichita St.,81,13.83,48,10,Indiana,76,,5,3,
875,20-Mar-15,2015,2014-15,1,South,32.48,3,1,Duke,85,-1.39,184,16,Robert Morris,56,,29,15,
876,20-Mar-15,2015,2014-15,1,South,27.78,7,2,Gonzaga,86,1.41,152,15,North Dakota St.,76,,10,13,
877,20-Mar-15,2015,2014-15,1,South,19.02,23,7,Iowa,83,15,36,10,Davidson,52,,31,3,
878,20-Mar-15,2015,2014-15,1,South,15.95,31,8,San Diego St.,76,13.7,50,9,St. John's,64,,12,1,
879,20-Mar-15,2015,2014-15,1,West,33.72,2,1,Wisconsin,86,2.38,140,16,Coastal Carolina,72,,14,15,
880,20-Mar-15,2015,2014-15,1,West,14.92,38,9,Oklahoma St.,73,13.88,45,8,Oregon,79,,6,1,
881,21-Mar-15,2015,2014-15,2,East,30.65,5,1,Villanova,68,15.93,32,8,North Carolina St.,71,,3,-7,8 over 1
882,21-Mar-15,2015,2014-15,2,Midwest,36.91,1,1,Kentucky,64,14.15,43,8,Cincinnati,51,,13,7,
883,21-Mar-15,2015,2014-15,2,Midwest,24.96,9,3,Notre Dame,67,20.09,20,6,Butler,64,1 OT,3,3,
884,21-Mar-15,2015,2014-15,2,South,14.65,40,11,UCLA,92,3.06,135,14,UAB,75,,17,3,
885,21-Mar-15,2015,2014-15,2,West,32.36,4,2,Arizona,73,20.75,19,10,Ohio St.,58,,15,8,
886,21-Mar-15,2015,2014-15,2,West,23.85,10,4,North Carolina,87,16.44,29,5,Arkansas,78,,9,1,
887,21-Mar-15,2015,2014-15,2,West,19.49,21,6,Xavier,75,10.32,68,14,Georgia St.,67,,8,8,
888,21-Mar-15,2015,2014-15,2,South,27.24,8,5,Utah,75,19.13,22,4,Georgetown,64,,11,-1,
889,22-Mar-15,2015,2014-15,2,East,30.06,6,2,Virginia,54,21.72,15,7,Michigan St.,60,,6,-5,7 over 2
890,22-Mar-15,2015,2014-15,2,Midwest,22.72,12,2,Kansas,65,22.21,13,7,Wichita St.,78,,13,-5,7 over 2
891,22-Mar-15,2015,2014-15,2,East,22.8,11,3,Oklahoma,72,14.24,42,11,Dayton,66,,6,8,
892,22-Mar-15,2015,2014-15,2,East,21.21,17,4,Louisville,66,20.98,18,5,Northern Iowa,53,,13,1,
893,22-Mar-15,2015,2014-15,2,South,32.48,3,1,Duke,68,15.95,31,8,San Diego St.,49,,19,7,
894,22-Mar-15,2015,2014-15,2,South,27.78,7,2,Gonzaga,87,19.02,23,7,Iowa,69,,18,5,
895,22-Mar-15,2015,2014-15,2,West,33.72,2,1,Wisconsin,72,13.88,45,8,Oregon,65,,7,7,
896,22-Mar-15,2015,2014-15,2,Midwest,17.64,25,5,West Virginia,69,15.68,33,4,Maryland,59,,10,-1,
897,26-Mar-15,2015,2014-15,3,Midwest,36.91,1,1,Kentucky,78,17.64,25,5,West Virginia,39,,39,4,
898,26-Mar-15,2015,2014-15,3,Midwest,24.96,9,3,Notre Dame,81,22.21,13,7,Wichita St.,70,,11,4,
899,26-Mar-15,2015,2014-15,3,West,33.72,2,1,Wisconsin,79,23.85,10,4,North Carolina,72,,7,3,
900,26-Mar-15,2015,2014-15,3,West,32.36,4,2,Arizona,68,19.49,21,6,Xavier,60,,8,4,
901,27-Mar-15,2015,2014-15,3,East,22.8,11,3,Oklahoma,58,21.72,15,7,Michigan St.,62,,4,-4,7 over 3
902,27-Mar-15,2015,2014-15,3,East,21.21,17,4,Louisville,75,15.93,32,8,North Carolina St.,65,,10,4,
903,27-Mar-15,2015,2014-15,3,South,32.48,3,1,Duke,63,27.24,8,5,Utah,57,,6,4,
904,27-Mar-15,2015,2014-15,3,South,27.78,7,2,Gonzaga,74,14.65,40,11,UCLA,62,,12,9,
905,28-Mar-15,2015,2014-15,4,Midwest,36.91,1,1,Kentucky,68,24.96,9,3,Notre Dame,66,,2,2,
906,28-Mar-15,2015,2014-15,4,West,33.72,2,1,Wisconsin,85,32.36,4,2,Arizona,78,,7,1,
907,29-Mar-15,2015,2014-15,4,East,21.72,15,7,Michigan St.,76,21.21,17,4,Louisville,70,1 OT,6,-3,7 over 4
908,29-Mar-15,2015,2014-15,4,South,32.48,3,1,Duke,66,27.78,7,2,Gonzaga,52,,14,1,
909,4-Apr-15,2015,2014-15,5,Final Four,32.48,3,1,Duke,81,21.72,15,7,Michigan St.,61,,20,6,
910,4-Apr-15,2015,2014-15,5,Final Four,36.91,1,1,Kentucky,64,33.72,2,1,Wisconsin,71,,7,0,
911,6-Apr-15,2015,2014-15,6,Championship,33.72,2,1,Wisconsin,63,32.48,3,1,Duke,68,,5,0,
912,15-Mar-16,2016,2015-16,PI,East,-0.08,162,16,Florida Gulf Coast,96,-10.63,280,16,Fairleigh Dickinson,65,,31,0,
913,15-Mar-16,2016,2015-16,PI,South,22.53,13,11,Wichita St.,70,18.76,25,11,Vanderbilt,50,,20,0,
914,16-Mar-16,2016,2015-16,PI,East,14.15,50,11,Michigan,67,11.5,65,11,Tulsa,62,,5,0,
915,16-Mar-16,2016,2015-16,PI,West,-5.75,229,16,Southern,55,-11.39,285,16,Holy Cross,59,,4,0,
916,17-Mar-16,2016,2015-16,1,Midwest,23.85,9,5,Purdue,83,13.24,56,12,Arkansas Little Rock,85,2 OT,2,-7,12 over 5
917,17-Mar-16,2016,2015-16,1,West,19.06,24,5,Baylor,75,14.33,47,12,Yale,79,,4,-7,12 over 5
918,17-Mar-16,2016,2015-16,1,Midwest,20.82,21,11,Gonzaga,68,18.27,29,6,Seton Hall,52,,16,-5,11 over 6
919,17-Mar-16,2016,2015-16,1,South,22.53,13,11,Wichita St.,65,20.97,19,6,Arizona,55,,10,-5,11 over 6
920,17-Mar-16,2016,2015-16,1,East,29.82,2,1,North Carolina,83,-0.08,162,16,Florida Gulf Coast,67,,16,15,
921,17-Mar-16,2016,2015-16,1,East,25.14,6,4,Kentucky,85,8.13,94,13,Stony Brook,57,,28,9,
922,17-Mar-16,2016,2015-16,1,East,23.05,11,5,Indiana,99,6.5,109,12,Chattanooga,74,,25,7,
923,17-Mar-16,2016,2015-16,1,Midwest,29.64,4,1,Virginia,81,-7.4,248,16,Hampton,45,,36,15,
924,17-Mar-16,2016,2015-16,1,Midwest,16.79,33,3,Utah,80,6.63,108,14,Fresno St.,69,,11,11,
925,17-Mar-16,2016,2015-16,1,Midwest,20.95,20,4,Iowa St.,94,7.13,104,13,Iona,81,,13,9,
926,17-Mar-16,2016,2015-16,1,South,29.67,3,1,Kansas,105,-5.1,217,16,Austin Peay,79,,26,15,
927,17-Mar-16,2016,2015-16,1,South,22.44,15,3,Miami FL,79,2.95,138,14,Buffalo,72,,7,11,
928,17-Mar-16,2016,2015-16,1,West,21.87,17,4,Duke,93,9.21,83,13,UNC Wilmington,85,,8,9,
929,17-Mar-16,2016,2015-16,1,East,14.49,44,9,Providence,70,14.25,49,8,USC,69,,1,-1,
930,17-Mar-16,2016,2015-16,1,Midwest,17.27,30,9,Butler,71,13.78,54,8,Texas Tech,61,,10,-1,
931,17-Mar-16,2016,2015-16,1,South,18.71,26,9,Connecticut,74,12.91,57,8,Colorado,67,,7,-1,
932,18-Mar-16,2016,2015-16,1,Midwest,27.97,5,2,Michigan St.,81,4.76,119,15,Middle Tennessee,90,,9,-13,15 over 2
933,18-Mar-16,2016,2015-16,1,East,24.45,8,3,West Virginia,56,15.62,41,14,Stephen F. Austin,70,,14,-11,14 over 3
934,18-Mar-16,2016,2015-16,1,South,18.32,28,4,California,66,12.16,60,13,Hawaii,77,,11,-9,13 over 4
935,18-Mar-16,2016,2015-16,1,West,16.19,39,6,Texas,72,11.13,67,11,Northern Iowa,75,,3,-5,11 over 6
936,18-Mar-16,2016,2015-16,1,Midwest,18.57,27,10,Syracuse,70,12.63,59,7,Dayton,51,,19,-3,10 over 7
937,18-Mar-16,2016,2015-16,1,West,17.07,31,10,VCU,75,11.65,64,7,Oregon St.,67,,8,-3,10 over 7
938,18-Mar-16,2016,2015-16,1,East,22.52,14,2,Xavier,71,2.45,142,15,Weber St.,53,,18,13,
939,18-Mar-16,2016,2015-16,1,East,16.6,36,6,Notre Dame,70,14.15,50,11,Michigan,63,,7,5,
940,18-Mar-16,2016,2015-16,1,East,16.6,37,10,Pittsburgh,43,16.55,38,7,Wisconsin,47,,4,3,
941,18-Mar-16,2016,2015-16,1,South,32.01,1,2,Villanova,86,3.44,131,15,UNC Asheville,56,,30,13,
942,18-Mar-16,2016,2015-16,1,South,20.25,22,5,Maryland,79,9.57,80,12,South Dakota St.,74,,5,7,
943,18-Mar-16,2016,2015-16,1,South,20.24,23,7,Iowa,72,8.82,86,10,Temple,70,1 OT,2,3,
944,18-Mar-16,2016,2015-16,1,West,22.68,12,1,Oregon,91,-11.39,285,16,Holy Cross,52,,39,15,
945,18-Mar-16,2016,2015-16,1,West,23.78,10,2,Oklahoma,82,6.26,110,15,Cal St. Bakersfield,68,,14,13,
946,18-Mar-16,2016,2015-16,1,West,21.26,18,3,Texas A&M,92,3.74,127,14,Green Bay,65,,27,11,
947,18-Mar-16,2016,2015-16,1,West,17.06,32,9,Cincinnati,76,15.37,43,8,Saint Joseph's,78,,2,1,
948,19-Mar-16,2016,2015-16,2,Midwest,20.82,21,11,Gonzaga,82,16.79,33,3,Utah,59,,23,-8,11 over 3
949,19-Mar-16,2016,2015-16,2,East,29.82,2,1,North Carolina,85,14.49,44,9,Providence,66,,19,8,
950,19-Mar-16,2016,2015-16,2,Midwest,29.64,4,1,Virginia,77,17.27,30,9,Butler,69,,8,8,
951,19-Mar-16,2016,2015-16,2,Midwest,20.95,20,4,Iowa St.,78,20.95,20,4,Iowa St.,78,,17,8,
952,19-Mar-16,2016,2015-16,2,South,29.67,3,1,Kansas,73,18.71,26,9,Connecticut,61,,12,8,
953,19-Mar-16,2016,2015-16,2,South,22.53,13,11,Wichita St.,57,22.44,15,3,Miami FL,65,,8,8,
954,19-Mar-16,2016,2015-16,2,West,21.87,17,4,Duke,71,14.33,47,12,Yale,64,,7,8,
955,19-Mar-16,2016,2015-16,2,East,25.14,6,4,Kentucky,67,23.05,11,5,Indiana,73,,6,-1,
956,20-Mar-16,2016,2015-16,2,East,22.52,14,2,Xavier,63,16.55,38,7,Wisconsin,66,,3,-5,7 over 2
957,20-Mar-16,2016,2015-16,2,East,16.6,36,6,Notre Dame,76,15.62,41,14,Stephen F. Austin,75,,1,8,
958,20-Mar-16,2016,2015-16,2,Midwest,18.57,27,10,Syracuse,75,4.76,119,15,Middle Tennessee,50,,25,5,
959,20-Mar-16,2016,2015-16,2,South,32.01,1,2,Villanova,87,20.24,23,7,Iowa,68,,19,5,
960,20-Mar-16,2016,2015-16,2,South,20.25,22,5,Maryland,73,12.16,60,13,Hawaii,60,,13,8,
961,20-Mar-16,2016,2015-16,2,West,22.68,12,1,Oregon,69,15.37,43,8,Saint Joseph's,64,,5,7,
962,20-Mar-16,2016,2015-16,2,West,23.78,10,2,Oklahoma,85,17.07,31,10,VCU,81,,4,8,
963,20-Mar-16,2016,2015-16,2,West,21.26,18,3,Texas A&M,92,11.13,67,11,Northern Iowa,88,2 OT,4,8,
964,24-Mar-16,2016,2015-16,3,South,29.67,3,1,Kansas,79,20.25,22,5,Maryland,63,,16,4,
965,24-Mar-16,2016,2015-16,3,South,32.01,1,2,Villanova,92,22.44,15,3,Miami FL,69,,23,1,
966,24-Mar-16,2016,2015-16,3,West,22.68,12,1,Oregon,82,21.87,17,4,Duke,68,,14,3,
967,24-Mar-16,2016,2015-16,3,West,23.78,10,2,Oklahoma,77,21.26,18,3,Texas A&M,63,,14,1,
968,25-Mar-16,2016,2015-16,3,East,29.82,2,1,North Carolina,101,23.05,11,5,Indiana,86,,15,4,
969,25-Mar-16,2016,2015-16,3,East,16.6,36,6,Notre Dame,61,16.55,38,7,Wisconsin,56,,5,1,
970,25-Mar-16,2016,2015-16,3,Midwest,29.64,4,1,Virginia,84,20.95,20,4,Iowa St.,71,,13,3,
971,25-Mar-16,2016,2015-16,3,Midwest,20.82,21,11,Gonzaga,60,18.57,27,10,Syracuse,63,,3,1,
972,26-Mar-16,2016,2015-16,4,South,32.01,1,2,Villanova,64,29.67,3,1,Kansas,59,,5,-1,
973,26-Mar-16,2016,2015-16,4,West,23.78,10,2,Oklahoma,80,22.68,12,1,Oregon,68,,12,-1,
974,27-Mar-16,2016,2015-16,4,Midwest,29.64,4,1,Virginia,62,18.57,27,10,Syracuse,68,,6,-9,10 over 1
975,27-Mar-16,2016,2015-16,4,East,29.82,2,1,North Carolina,88,16.6,36,6,Notre Dame,74,,14,5,
976,2-Apr-16,2016,2015-16,5,Final Four,29.82,2,1,North Carolina,83,18.57,27,10,Syracuse,66,,17,9,
977,2-Apr-16,2016,2015-16,5,Final Four,32.01,1,2,Villanova,95,23.78,10,2,Oklahoma,51,,44,0,
978,4-Apr-16,2016,2015-16,6,Championship,32.01,1,2,Villanova,77,29.82,2,1,North Carolina,74,,3,-1,
979,14-Mar-17,2017,2016-17,PI,South,17.44,30,11,Kansas St.,95,16.25,36,11,Wake Forest,88,,7,0,
980,14-Mar-17,2017,2016-17,PI,East,-0.52,178,16,New Orleans,66,-3.86,209,16,Mount St. Mary's,67,,1,0,
981,15-Mar-17,2017,2016-17,PI,Midwest,0.36,161,16,North Carolina Central,63,-4.41,218,16,UC Davis,67,,4,0,
982,15-Mar-17,2017,2016-17,PI,East,13.45,53,11,USC,75,12.43,60,11,Providence,71,,4,0,
983,16-Mar-17,2017,2016-17,1,South,16,37,5,Minnesota,72,14.95,43,12,Middle Tennessee,81,,9,-7,12 over 5
984,16-Mar-17,2017,2016-17,1,West,16.7,31,11,Xavier,76,14.34,46,6,Maryland,65,,11,-5,11 over 6
985,16-Mar-17,2017,2016-17,1,West,19.74,27,5,Notre Dame,60,12.61,58,12,Princeton,58,,2,7,
986,16-Mar-17,2017,2016-17,1,East,24.29,12,5,Virginia,76,12.46,59,12,UNC Wilmington,71,,5,7,
987,16-Mar-17,2017,2016-17,1,South,20.76,25,4,Butler,76,4.53,113,13,Winthrop,64,,12,9,
988,16-Mar-17,2017,2016-17,1,West,32.05,1,1,Gonzaga,66,8.99,78,16,San Diego St.,46,,20,15,
989,16-Mar-17,2017,2016-17,1,West,27.17,7,4,West Virginia,86,9.38,76,13,Bucknell,80,,6,9,
990,16-Mar-17,2017,2016-17,1,East,27.5,5,4,Florida,80,11.1,67,13,East Tennessee St.,65,,15,9,
991,16-Mar-17,2017,2016-17,1,West,16.53,33,9,Vanderbilt,66,15.81,38,8,Northwestern,68,,2,1,
992,16-Mar-17,2017,2016-17,1,East,29.88,2,1,Villanova,76,-3.86,209,16,Mount St. Mary's,56,,20,15,
993,16-Mar-17,2017,2016-17,1,West,23.67,15,7,Saint Mary's,85,14.07,48,10,VCU,77,,8,3,
994,16-Mar-17,2017,2016-17,1,Midwest,23.12,19,4,Purdue,80,11.67,63,13,Vermont,70,,10,9,
995,16-Mar-17,2017,2016-17,1,West,20.06,26,3,Florida St.,86,5.07,108,14,Florida Gulf Coast,80,,6,11,
996,16-Mar-17,2017,2016-17,1,East,22.99,21,8,Wisconsin,84,13.8,50,9,Virginia Tech,74,,10,1,
997,16-Mar-17,2017,2016-17,1,Midwest,23.45,17,5,Iowa St.,84,13.31,54,12,Nevada,73,,11,7,
998,16-Mar-17,2017,2016-17,1,West,23.31,18,2,Arizona,100,0.04,168,15,North Dakota,82,,18,13,
999,17-Mar-17,2017,2016-17,1,East,24.73,11,6,SMU,65,13.45,53,11,USC,66,,1,-5,11 over 6
1000,17-Mar-17,2017,2016-17,1,Midwest,18.83,28,6,Creighton,72,16.26,34,11,Rhode Island,84,,12,-5,11 over 6
1001,17-Mar-17,2017,2016-17,1,South,26.14,8,10,Wichita St.,64,15.57,39,7,Dayton,58,,6,-3,10 over 7
1002,17-Mar-17,2017,2016-17,1,Midwest,23.05,20,7,Michigan,92,22.48,22,10,Oklahoma St.,91,,1,3,
1003,17-Mar-17,2017,2016-17,1,East,24.23,13,3,Baylor,91,7.89,84,14,New Mexico St.,73,,18,11,
1004,17-Mar-17,2017,2016-17,1,South,16.25,35,8,Arkansas,77,13.63,51,9,Seton Hall,71,,6,1,
1005,17-Mar-17,2017,2016-17,1,Midwest,25.02,10,3,Oregon,93,4.2,117,14,Iona,77,,16,11,
1006,17-Mar-17,2017,2016-17,1,Midwest,25.51,9,2,Louisville,78,0.63,157,15,Jacksonville St.,63,,15,13,
1007,17-Mar-17,2017,2016-17,1,South,28.22,3,1,North Carolina,103,-4.04,212,16,Texas Southern,64,,39,15,
1008,17-Mar-17,2017,2016-17,1,Midwest,27.45,6,1,Kansas,100,-4.41,218,16,UC Davis,62,,38,15,
1009,17-Mar-17,2017,2016-17,1,East,24.17,14,2,Duke,87,2.04,137,15,Troy,65,,22,13,
1010,17-Mar-17,2017,2016-17,1,South,22.18,23,6,Cincinnati,75,17.44,30,11,Kansas St.,61,,14,5,
1011,17-Mar-17,2017,2016-17,1,East,20.8,24,7,South Carolina,93,16.58,32,10,Marquette,73,,20,3,
1012,17-Mar-17,2017,2016-17,1,South,23.63,16,3,UCLA,97,1.68,141,14,Kent St.,80,,17,11,
1013,17-Mar-17,2017,2016-17,1,South,27.72,4,2,Kentucky,79,1.91,138,15,Northern Kentucky,70,,9,13,
1014,17-Mar-17,2017,2016-17,1,Midwest,15.51,40,9,Michigan St.,78,15.03,42,8,Miami FL,58,,20,-1,
1015,18-Mar-17,2017,2016-17,2,West,20.06,26,3,Florida St.,66,16.7,31,11,Xavier,91,,25,-8,11 over 3
1016,18-Mar-17,2017,2016-17,2,East,29.88,2,1,Villanova,62,22.99,21,8,Wisconsin,65,,3,-7,8 over 1
1017,18-Mar-17,2017,2016-17,2,West,27.17,7,4,West Virginia,83,19.74,27,5,Notre Dame,71,,12,1,
1018,18-Mar-17,2017,2016-17,2,West,32.05,1,1,Gonzaga,79,15.81,38,8,Northwestern,73,,6,7,
1019,18-Mar-17,2017,2016-17,2,South,20.76,25,4,Butler,74,14.95,43,12,Middle Tennessee,65,,9,8,
1020,18-Mar-17,2017,2016-17,2,West,23.67,15,7,Saint Mary's,60,23.31,18,2,Arizona,69,,9,5,
1021,18-Mar-17,2017,2016-17,2,East,27.5,5,4,Florida,65,24.29,12,5,Virginia,39,,26,1,
1022,18-Mar-17,2017,2016-17,2,Midwest,23.45,17,5,Iowa St.,76,23.12,19,4,Purdue,80,,4,1,
1023,19-Mar-17,2017,2016-17,2,Midwest,25.51,9,2,Louisville,69,23.05,20,7,Michigan,73,,4,-5,7 over 2
1024,19-Mar-17,2017,2016-17,2,East,24.17,14,2,Duke,81,20.8,24,7,South Carolina,88,,7,-5,7 over 2
1025,19-Mar-17,2017,2016-17,2,South,27.72,4,2,Kentucky,65,26.14,8,10,Wichita St.,62,,3,8,
1026,19-Mar-17,2017,2016-17,2,Midwest,27.45,6,1,Kansas,90,15.51,40,9,Michigan St.,70,,20,8,
1027,19-Mar-17,2017,2016-17,2,South,28.22,3,1,North Carolina,72,16.25,35,8,Arkansas,65,,7,7,
1028,19-Mar-17,2017,2016-17,2,Midwest,25.02,10,3,Oregon,75,16.26,34,11,Rhode Island,72,,3,8,
1029,19-Mar-17,2017,2016-17,2,East,24.23,13,3,Baylor,82,13.45,53,11,USC,78,,4,8,
1030,19-Mar-17,2017,2016-17,2,South,23.63,16,3,UCLA,79,22.18,23,6,Cincinnati,67,,12,3,
1031,23-Mar-17,2017,2016-17,3,West,23.31,18,2,Arizona,71,16.7,31,11,Xavier,73,,2,-9,11 over 2
1032,23-Mar-17,2017,2016-17,3,Midwest,25.02,10,3,Oregon,69,23.05,20,7,Michigan,68,,1,4,
1033,23-Mar-17,2017,2016-17,3,West,32.05,1,1,Gonzaga,61,27.17,7,4,West Virginia,58,,3,3,
1034,23-Mar-17,2017,2016-17,3,Midwest,27.45,6,1,Kansas,98,23.12,19,4,Purdue,66,,32,3,
1035,24-Mar-17,2017,2016-17,3,East,24.23,13,3,Baylor,50,20.8,24,7,South Carolina,70,,20,-4,7 over 3
1036,24-Mar-17,2017,2016-17,3,South,28.22,3,1,North Carolina,92,20.76,25,4,Butler,80,,12,3,
1037,24-Mar-17,2017,2016-17,3,South,27.72,4,2,Kentucky,86,23.63,16,3,UCLA,75,,11,1,
1038,24-Mar-17,2017,2016-17,3,East,27.5,5,4,Florida,84,22.99,21,8,Wisconsin,83,1 OT,1,4,
1039,25-Mar-17,2017,2016-17,4,Midwest,27.45,6,1,Kansas,60,25.02,10,3,Oregon,74,,14,-2,
1040,25-Mar-17,2017,2016-17,4,West,32.05,1,1,Gonzaga,83,16.7,31,11,Xavier,59,,24,10,
1041,26-Mar-17,2017,2016-17,4,East,27.5,5,4,Florida,70,20.8,24,7,South Carolina,77,,7,-3,7 over 4
1042,26-Mar-17,2017,2016-17,4,South,28.22,3,1,North Carolina,75,27.72,4,2,Kentucky,73,,2,1,
1043,1-Apr-17,2017,2016-17,5,Final Four,32.05,1,1,Gonzaga,77,20.8,24,7,South Carolina,73,,4,6,
1044,1-Apr-17,2017,2016-17,5,Final Four,28.22,3,1,North Carolina,77,25.02,10,3,Oregon,76,,1,2,
1045,3-Apr-17,2017,2016-17,6,Championship,32.05,1,1,Gonzaga,65,28.22,3,1,North Carolina,71,,6,0,
1046,13-Mar-18,2018,2017-18,PI,East,0.07,170,16,Radford,71,-8.27,259,16,LIU Brooklyn,61,,10,0,
1047,13-Mar-18,2018,2017-18,PI,East,13.52,56,11,UCLA,58,11.21,68,11,St. Bonaventure,65,,7,0,
1048,14-Mar-18,2018,2017-18,PI,West,-6.65,243,16,Texas Southern,64,-13.41,316,16,North Carolina Central,46,,18,0,
1049,14-Mar-18,2018,2017-18,PI,Midwest,14.82,41,11,Syracuse,60,14.13,49,11,Arizona St.,56,,4,0,
1050,15-Mar-18,2018,2017-18,1,South,22.27,13,3,Tennessee,73,2.89,133,14,Wright St.,47,,26,11,
1051,15-Mar-18,2018,2017-18,1,West,23.03,10,4,Gonzaga,68,9.22,82,13,UNC Greensboro,64,,4,9,
1052,15-Mar-18,2018,2017-18,1,Midwest,14.16,48,10,Oklahoma,78,13.93,52,7,Rhode Island,83,1 OT,5,3,
1053,15-Mar-18,2018,2017-18,1,Midwest,23.49,9,1,Kansas,76,3.69,125,16,Penn,60,,16,15,
1054,15-Mar-18,2018,2017-18,1,Midwest,28.86,3,2,Duke,89,2.63,137,15,Iona,67,,22,13,
1055,15-Mar-18,2018,2017-18,1,West,21.16,16,5,Ohio St.,81,10.2,78,12,South Dakota St.,73,,8,7,
1056,15-Mar-18,2018,2017-18,1,South,16.39,31,11,Loyola Chicago,64,15.43,37,6,Miami FL,62,,2,-5,11 over 6
1057,15-Mar-18,2018,2017-18,1,Midwest,18.04,26,8,Seton Hall,94,14.52,46,9,North Carolina St.,83,,11,1,
1058,15-Mar-18,2018,2017-18,1,East,33.76,1,1,Villanova,87,0.07,170,16,Radford,61,,26,15,
1059,15-Mar-18,2018,2017-18,1,South,20.44,17,5,Kentucky,78,14.7,43,12,Davidson,73,,5,7,
1060,15-Mar-18,2018,2017-18,1,East,22.59,11,3,Texas Tech,70,5.58,112,14,Stephen F. Austin,60,,10,11,
1061,15-Mar-18,2018,2017-18,1,West,20.24,18,6,Houston,67,14.09,50,11,San Diego St.,65,,2,5,
1062,15-Mar-18,2018,2017-18,1,East,16.03,33,8,Virginia Tech,83,13.41,57,9,Alabama,86,,3,-1,
1063,15-Mar-18,2018,2017-18,1,South,17.7,28,4,Arizona,68,11.53,67,13,Buffalo,89,,21,-9,13 over 4
1064,15-Mar-18,2018,2017-18,1,East,18.96,22,6,Florida,77,11.21,68,11,St. Bonaventure,62,,15,5,
1065,15-Mar-18,2018,2017-18,1,West,24.2,7,3,Michigan,61,10.4,72,14,Montana,47,,14,11,
1066,16-Mar-18,2018,2017-18,1,South,26.6,4,2,Cincinnati,68,6.92,101,15,Georgia St.,53,,15,13,
1067,16-Mar-18,2018,2017-18,1,East,26.27,5,2,Purdue,74,0.62,162,15,Cal St. Fullerton,48,,26,13,
1068,16-Mar-18,2018,2017-18,1,East,19.03,21,4,Wichita St.,75,6.53,105,13,Marshall,81,,6,-9,13 over 4
1069,16-Mar-18,2018,2017-18,1,West,16.96,29,7,Texas A&M,73,12.17,63,10,Providence,69,,4,3,
1070,16-Mar-18,2018,2017-18,1,West,23.59,8,2,North Carolina,84,0.43,167,15,Lipscomb,66,,18,13,
1071,16-Mar-18,2018,2017-18,1,East,19.05,20,10,Butler,79,14.69,44,7,Arkansas,62,,17,-3,10 over 7
1072,16-Mar-18,2018,2017-18,1,South,18.39,25,7,Nevada,87,15.43,36,10,Texas,83,1 OT,4,3,
1073,16-Mar-18,2018,2017-18,1,East,22.44,12,5,West Virginia,85,12.19,62,12,Murray St.,68,,17,7,
1074,16-Mar-18,2018,2017-18,1,West,21.51,15,1,Xavier,102,-6.65,243,16,Texas Southern,83,,19,15,
1075,16-Mar-18,2018,2017-18,1,Midwest,25.41,6,3,Michigan St.,82,7.31,97,14,Bucknell,78,,4,11,
1076,16-Mar-18,2018,2017-18,1,Midwest,18.69,23,4,Auburn,62,18.69,23,4,Auburn,62,,4,9,
1077,16-Mar-18,2018,2017-18,1,South,16.91,30,8,Creighton,59,14.77,42,9,Kansas St.,69,,10,-1,
1078,16-Mar-18,2018,2017-18,1,Midwest,21.65,14,5,Clemson,79,12.92,60,12,New Mexico St.,68,,11,7,
1079,16-Mar-18,2018,2017-18,1,South,29.53,2,1,Virginia,54,0.5,166,16,UMBC,74,,20,-15,16 over 1
1080,16-Mar-18,2018,2017-18,1,Midwest,18.47,24,6,TCU,52,14.82,41,11,Syracuse,57,,5,-5,11 over 6
1081,16-Mar-18,2018,2017-18,1,West,17.77,27,9,Florida St.,67,14.83,40,8,Missouri,54,,13,-1,
1082,17-Mar-18,2018,2017-18,2,East,33.76,1,1,Villanova,81,13.41,57,9,Alabama,58,,23,8,
1083,17-Mar-18,2018,2017-18,2,Midwest,28.86,3,2,Duke,87,13.93,52,7,Rhode Island,62,,25,5,
1084,17-Mar-18,2018,2017-18,2,West,23.03,10,4,Gonzaga,90,21.16,16,5,Ohio St.,84,,6,1,
1085,17-Mar-18,2018,2017-18,2,South,11.53,67,5,Buffalo,95,11.53,67,13,Buffalo,75,,20,8,
1086,17-Mar-18,2018,2017-18,2,South,22.27,13,3,Tennessee,62,16.39,31,11,Loyola Chicago,63,,1,-8,11 over 3
1087,17-Mar-18,2018,2017-18,2,Midwest,23.49,9,1,Kansas,83,18.04,26,8,Seton Hall,79,,4,7,
1088,17-Mar-18,2018,2017-18,2,East,22.59,11,3,Texas Tech,69,18.96,22,6,Florida,66,,3,3,
1089,17-Mar-18,2018,2017-18,2,West,24.2,7,3,Michigan,64,20.24,18,6,Houston,63,,1,3,
1090,18-Mar-18,2018,2017-18,2,Midwest,21.65,14,5,Clemson,84,18.69,23,4,Auburn,53,,31,-1,
1091,18-Mar-18,2018,2017-18,2,South,26.6,4,2,Cincinnati,73,18.39,25,7,Nevada,75,,2,-5,7 over 2
1092,18-Mar-18,2018,2017-18,2,West,23.59,8,2,North Carolina,65,16.96,29,7,Texas A&M,86,,21,-5,7 over 2
1093,18-Mar-18,2018,2017-18,2,East,26.27,5,2,Purdue,76,19.05,20,10,Butler,73,,3,8,
1094,18-Mar-18,2018,2017-18,2,Midwest,25.41,6,3,Michigan St.,53,14.82,41,11,Syracuse,55,,2,-8,11 over 3
1095,18-Mar-18,2018,2017-18,2,South,14.77,42,9,Kansas St.,50,0.5,166,16,UMBC,43,,7,7,
1096,18-Mar-18,2018,2017-18,2,West,21.51,15,1,Xavier,70,17.77,27,9,Florida St.,75,,5,-8,9 over 1
1097,18-Mar-18,2018,2017-18,2,East,22.44,12,5,West Virginia,89,6.53,105,13,Marshall,62,,27,8,
1098,22-Mar-18,2018,2017-18,3,West,24.2,7,3,Michigan,99,16.96,29,7,Texas A&M,72,,27,4,
1099,22-Mar-18,2018,2017-18,3,South,18.39,25,7,Nevada,68,16.39,31,11,Loyola Chicago,69,,1,-4,11 over 7
1100,22-Mar-18,2018,2017-18,3,South,23.49,9,9,Kansas,61,20.44,17,5,Kentucky,58,,3,-4,9 over 5
1101,22-Mar-18,2018,2017-18,3,West,23.03,10,4,Gonzaga,60,17.77,27,9,Florida St.,75,,15,-5,9 over 4
1102,23-Mar-18,2018,2017-18,3,East,33.76,1,1,Villanova,90,22.44,12,5,West Virginia,78,,12,4,
1103,23-Mar-18,2018,2017-18,3,Midwest,23.49,9,1,Kansas,80,21.65,14,5,Clemson,76,,4,4,
1104,23-Mar-18,2018,2017-18,3,Midwest,28.86,3,2,Duke,69,14.82,41,11,Syracuse,65,,4,9,
1105,23-Mar-18,2018,2017-18,3,East,26.27,5,2,Purdue,65,22.59,11,3,Texas Tech,78,,13,-1,
1106,24-Mar-18,2018,2017-18,4,South,16.39,31,11,Loyola Chicago,78,14.77,42,9,Kansas St.,62,,16,-2,
1107,24-Mar-18,2018,2017-18,4,West,24.2,7,3,Michigan,58,17.77,27,9,Florida St.,54,,4,6,
1108,25-Mar-18,2018,2017-18,4,East,33.76,1,1,Villanova,71,22.59,11,3,Texas Tech,59,,12,2,
1109,25-Mar-18,2018,2017-18,4,Midwest,28.86,3,2,Duke,81,23.49,9,1,Kansas,85,1 OT,4,1,
1110,31-Mar-18,2018,2017-18,5,Final Four,24.2,7,3,Michigan,69,16.39,31,11,Loyola Chicago,57,,12,8,
1111,31-Mar-18,2018,2017-18,5,Final Four,33.76,1,1,Villanova,95,23.49,9,1,Kansas,79,,16,0,
1112,2-Apr-18,2018,2017-18,6,Championship,33.76,1,1,Villanova,79,24.2,7,3,Michigan,62,,17,2,
1113,19-Mar-19,2019,2018-19,PI,West,-4.25,208,16,Fairleigh Dickinson,82,-4.3,209,16,Prairie View A&M,76,,6,0,
1114,19-Mar-19,2019,2018-19,PI,East,13.07,54,11,Belmont,81,9.43,76,11,Temple,70,,11,0,
1115,20-Mar-19,2019,2018-19,PI,West,11.2,61,11,Arizona St.,74,8.74,79,11,St. John's,65,,9,0,
1116,20-Mar-19,2019,2018-19,PI,West,-4.25,208,16,Fairleigh Dickinson,82,-4.3,209,16,Prairie View A&M,76,,6,0,
1117,21-Mar-19,2019,2018-19,1,East,21.01,17,7,Louisville,76,14.47,47,10,Minnesota,86,,10,-3,10 over 7
1118,21-Mar-19,2019,2018-19,1,East,21,18,3,LSU,79,8.59,82,14,Yale,74,,5,11,
1119,21-Mar-19,2019,2018-19,1,Midwest,22.11,15,6,Auburn,78,13.6,49,12,New Mexico St.,77,,1,6,
1120,21-Mar-19,2019,2018-19,1,West,22.56,14,4,Florida St.,76,8.72,80,13,Vermont,69,,7,9,
1121,21-Mar-19,2019,2018-19,1,East,31.11,4,2,Michigan St.,76,-0.36,166,15,Bradley,65,,11,13,
1122,21-Mar-19,2019,2018-19,1,East,19.98,24,6,Maryland,79,13.07,54,11,Belmont,77,,2,5,
1123,21-Mar-19,2019,2018-19,1,Midwest,20.75,19,4,Kansas,87,8.74,78,13,Northeastern,53,,34,9,
1124,21-Mar-19,2019,2018-19,1,West,18.41,27,5,Marquette,64,13.29,52,12,Murray St.,83,,19,-7,12 over 5
1125,21-Mar-19,2019,2018-19,1,South,18.77,26,6,Villanova,61,17.73,31,11,Saint Mary's,57,,4,5,
1126,21-Mar-19,2019,2018-19,1,West,18.93,25,7,Nevada,61,18.32,28,10,Florida,70,,9,-3,10 over 7
1127,21-Mar-19,2019,2018-19,1,Midwest,27.48,8,2,Kentucky,79,2.1,145,15,Abilene Christian,44,,35,13,
1128,21-Mar-19,2019,2018-19,1,West,32.86,2,1,Gonzaga,87,-4.25,208,16,Fairleigh Dickinson,49,,38,15,
1129,21-Mar-19,2019,2018-19,1,Midwest,20.72,20,1,Wofford,84,12.9,55,10,Seton Hall,68,,16,9,
1130,21-Mar-19,2019,2018-19,1,South,26.04,10,3,Purdue,61,5.57,111,14,Old Dominion,48,,13,11,
1131,21-Mar-19,2019,2018-19,1,West,29.67,5,2,Michigan,74,3.54,137,15,Montana,55,,19,13,
1132,21-Mar-19,2019,2018-19,1,West,16.3,34,8,Syracuse,69,15.3,41,9,Baylor,78,,9,-1,
1133,22-Mar-19,2019,2018-19,1,South,16.16,35,7,Cincinnati,72,15.95,36,10,Iowa,79,,7,-3,10 over 7
1134,22-Mar-19,2019,2018-19,1,South,15.55,38,9,Oklahoma,95,15.02,45,8,Mississippi,72,,23,-1,
1135,22-Mar-19,2019,2018-19,1,South,20.23,23,4,Kansas St.,64,9.47,75,13,UC Irvine,70,,6,-9,13 over 4
1136,22-Mar-19,2019,2018-19,1,West,26.77,9,3,Texas Tech,72,6.52,100,14,Northern Kentucky,57,,15,11,
1137,22-Mar-19,2019,2018-19,1,South,28.33,7,2,Tennessee,77,4.29,129,15,Colgate,70,,7,13,
1138,22-Mar-19,2019,2018-19,1,South,35.65,1,1,Virginia,71,-0.75,167,16,Gardner Webb,56,,15,15,
1139,22-Mar-19,2019,2018-19,1,West,20.33,22,6,Buffalo,91,11.2,61,11,Arizona St.,74,,17,5,
1140,22-Mar-19,2019,2018-19,1,South,23.67,12,5,Wisconsin,54,15.17,43,12,Oregon,72,,18,-7,12 over 5
1141,22-Mar-19,2019,2018-19,1,East,15.68,37,8,VCU,58,14.59,46,9,UCF,73,,15,-1,
1142,22-Mar-19,2019,2018-19,1,East,20.66,21,5,Mississippi St.,76,10.8,63,12,Liberty,80,,4,-7,12 over 5
1143,22-Mar-19,2019,2018-19,1,Midwest,16.66,33,8,Utah St.,61,13.33,51,9,Washington,78,,17,-1,
1144,22-Mar-19,2019,2018-19,1,Midwest,21.86,16,6,Iowa St.,59,15.03,44,11,Ohio St.,62,,3,-5,11 over 6
1145,22-Mar-19,2019,2018-19,1,Midwest,23.42,13,3,Houston,84,5.3,115,14,Georgia St.,55,,29,11,
1146,22-Mar-19,2019,2018-19,1,Midwest,29.18,6,1,North Carolina,88,-3.08,197,16,Iona,73,,15,15,
1147,22-Mar-19,2019,2018-19,1,East,31.97,3,1,Duke,85,-3.2,199,16,North Dakota St.,62,,23,15,
1148,22-Mar-19,2019,2018-19,1,East,24.47,11,4,Virginia Tech,66,6.21,105,13,Saint Louis,52,,14,9,
1149,23-Mar-19,2019,2018-19,2,East,21,18,3,LSU,69,19.98,24,6,Maryland,67, ,2,3,
1150,23-Mar-19,2019,2018-19,2,Midwest,27.48,8,2,Kentucky,62,20.72,20,7,Wofford,56,,6,5,
1151,23-Mar-19,2019,2018-19,2,West,29.67,5,2,Michigan,64,18.32,28,10,Florida,49,,15,8,
1152,23-Mar-19,2019,2018-19,2,West,22.56,14,4,Florida St.,90,13.29,52,12,Murray St.,62,,28,8,
1153,23-Mar-19,2019,2018-19,2,West,32.86,2,1,Gonzaga,83,15.3,41,9,Baylor,71,,12,8,
1154,23-Mar-19,2019,2018-19,2,East,31.11,4,2,Michigan St.,70,14.47,47,10,Minnesota,50,,20,8,
1155,23-Mar-19,2019,2018-19,2,South,26.04,10,3,Purdue,87,18.77,26,6,Villanova,61,,26,3,
1156,23-Mar-19,2019,2018-19,2,Midwest,22.11,15,5,Auburn,89,20.75,19,4,Kansas,75,,14,-1,
1157,24-Mar-19,2019,2018-19,2,South,28.33,7,2,Tennessee,83,15.95,36,10,Iowa,77,1 OT,6,8,
1158,24-Mar-19,2019,2018-19,2,Midwest,29.18,6,1,North Carolina,81,13.33,51,9,Washington,59,,22,8,
1159,24-Mar-19,2019,2018-19,2,East,31.97,3,1,Duke,77,14.59,46,9,UCF,76,,1,8,
1160,24-Mar-19,2019,2018-19,2,East,24.47,11,4,Virginia Tech,67,10.8,63,12,Liberty,58,,9,8,
1161,24-Mar-19,2019,2018-19,2,West,26.77,9,3,Texas Tech,78,20.33,22,6,Buffalo,58,,20,3,
1162,24-Mar-19,2019,2018-19,2,South,35.65,1,1,Virginia,63,15.55,38,9,Oklahoma,51,,12,8,
1163,24-Mar-19,2019,2018-19,2,Midwest,23.42,13,3,Houston,74,15.03,44,11,Ohio St.,59,,15,8,
1164,24-Mar-19,2019,2018-19,2,South,15.17,43,12,Oregon,73,9.47,75,13,UC Irvine,54,,19,1,
1165,28-Mar-19,2019,2018-19,3,South,28.33,7,2,Tennessee,94,26.04,10,3,Purdue,99,1 OT,5,-1,
1166,28-Mar-19,2019,2018-19,3,West,32.86,2,1,Gonzaga,72,22.56,14,4,Florida St.,58,,14,3,
1167,28-Mar-19,2019,2018-19,3,South,35.65,1,1,Virginia,53,15.17,43,12,Oregon,49,,4,11,
1168,28-Mar-19,2019,2018-19,3,West,29.67,5,2,Michigan,44,26.77,9,3,Texas Tech,63,,19,-1,
1169,29-Mar-19,2019,2018-19,3,East,31.97,3,1,Duke,75,24.47,11,4,Virginia Tech,73,,2,3,
1170,29-Mar-19,2019,2018-19,3,Midwest,29.18,6,1,North Carolina,80,22.11,15,5,Auburn,97,,17,-4,5 over 1
1171,29-Mar-19,2019,2018-19,3,East,31.11,4,2,Michigan St.,80,21,18,3,LSU,63,,17,1,
1172,29-Mar-19,2019,2018-19,3,Midwest,27.48,8,2,Kentucky,62,23.42,13,3,Houston,58,,4,1,
1173,30-Mar-19,2019,2018-19,4,West,32.86,2,1,Gonzaga,69,26.77,9,3,Texas Tech,75,,6,-2,
1174,30-Mar-19,2019,2018-19,4,South,35.65,1,1,Virginia,80,26.04,10,3,Purdue,75,1 OT,5,2,
1175,31-Mar-19,2019,2018-19,4,Midwest,27.48,8,2,Kentucky,71,22.11,15,5,Auburn,77,1 OT,6,-3,5 over 2
1176,31-Mar-19,2019,2018-19,4,East,31.97,3,1,Duke,67,31.11,4,2,Michigan St.,68,,1,-1,
1177,6-Apr-19,2019,2018-19,5,Final Four,35.65,1,1,Virginia,63,22.11,15,5,Auburn,62,,1,4,
1178,6-Apr-19,2019,2018-19,5,Final Four,29.67,5,2,Michigan,51,26.77,9,3,Texas Tech,61,,10,-1,
1179,8-Apr-19,2019,2018-19,6,Championship,35.65,1,1,Virginia,85,26.77,9,3,Texas Tech,77,1 OT,8,2,
